SIMPLIFIED	TRADITIONAL	PINYIN	TRANSLATION
就	就	jiù	then; at once; just; only; with regard to
要	要	yào, yāo	to want; to need; will/shall; important | demand; request
知道	知道	zhīdao	know; be aware of
吧	吧	ba, bā	particle indicating polite suggestion; | onomatopoeia | bar (serving drinks, providing internet access, etc.)
到	到	dào	arrive (at a place); until (a time)
对	對	duì	correct; a pair; to face; be opposite; to; towards
也	也	yě	also; too
还	還	hái, huán	still; yet; in addition; even | repay; to return
让	讓	ràng	ask; let; yield
给	給	gěi, jǐ	to give; to grant; (passive particle) | provide
过	過	guò	to pass; to cross; go over; (indicates a past experience)
得	得	dé, děi, de	obtain | must | (complement particle)
真	真	zhēn	real; true; genuine
着	著	zhe, zháo, zhuó	-ing (indicating action in progress) | to touch; to feel | to wear; apply
可以	可以	kěyǐ	can; may; possible; okay
别	別	bié, biè	don't do something; don't | depart; | other; difference; distinguish
走	走	zǒu	to walk; to go; to move (Kangxi radical 156)
告诉	告訴	gàosu	to tell; inform
因为	因為	yīnwèi	because
再	再	zài	again; once more
快	快	kuài	fast; quick; swift
但是	但是	dànshì	but; however
已经	已經	yǐjing	already
为什么	為什麼	wèishénme	why?; for what reason?
觉得	覺得	juéde	feel; think
它	它	tā	it
从	從	cóng	from; obey; observe
找	找	zhǎo	try to find; look for; seek; to give change
最	最	zuì	the most; -est; (indicator for superlative)
可能	可能	kěnéng	possible; maybe
次	次	cì	(mw for number of times of occurrence); nth; order
出	出	chū	go out; occur
孩子	孩子	háizi	child; children; son or daughter
所以	所以	suǒyǐ	so; therefore; as a result
两	兩	liǎng	two; 2; both; (unit of weight equal to 50 grams)
错	錯	cuò	mistake; error; blunder; miss an opportunity
等	等	děng	to wait; rank; equal; etc.
题	題	tí	topic; subject; question on a test or assignment
问	問	wèn	ask; inquire
问题	問題	wèntí	question; problem
一起	一起	yìqǐ	together; in the same place
开始	開始	kāishǐ	begin; to start; beginning
时间	時間	shíjiān	time; period
事情	事情	shìqing	matter; affair; thing; business
一下	一下	yíxià	a little bit/while; one time; once
非常	非常	fēicháng	extremely; extraordinary; very
希望	希望	xīwàng	to hope; wish for; to desire
准备	准備	zhǔnbèi	prepare; get ready
比	比	bǐ	compare; (indicates comparison) (Kangxi radical 81); to gesticulate as one talks
件	件	jiàn	(mw for things, clothes, and items)
意思	意思	yìsi	meaning; idea; opinion
第一	第一	dìyī	first; number 1
进	進	jìn	enter; come in
大家	大家	dàjiā	everyone
新	新	xīn	new; Xinjiang autonomous region (abbreviation)
您	您	nín	you (polite)
穿	穿	chuān	to wear; put on; penetrate
送	送	sòng	deliver; to carry; to give; send
玩	玩	wán	to play; have a good time; visit; enjoy
长	長	cháng, zhǎng	long; length | grow; chief (Kangxi radical 168)
小时	小時	xiǎoshí	hour
完	完	wán	to finish; be over; complete
每	每	měi	each; every
公司	公司	gōngsī	company; corporation
帮助	幫助	bāngzhù	help; assist; aid
晚上	晚上	wǎnshang	evening; night
说话	說話	shuōhuà	to talk; speak
门	門	mén	door; opening; gate (Kangxi radical 169)
女	女	nǚ	woman; female (Kangxi radical 38)
忙	忙	máng	busy
卖	賣	mài	to sell
高	高	gāo	high; tall (Kangxi radical 189)
房间	房間	fángjiān	room
路	路	lù	road; path; journey; route
懂	懂	dǒng	understand; know
正在	正在	zhèngzài	in the process of (doing something); currently
笑	笑	xiào	to laugh; to smile
远	遠	yuǎn	far; distant; remote
妻子	妻子	qīzi	wife
丈夫	丈夫	zhàngfu	husband; man
离	離	lí	leave; depart; go away; apart from
往	往	wǎng	to go (in a direction); towards; in the past
男	男	nán	male
眼睛	眼睛	yǎnjing	eye
快乐	快樂	kuàilè	happy
虽然	雖然	suīrán	although; even though
早上	早上	zǎoshang	(early) morning
药	藥	yào	medicine; drug; cure; chemical
身体	身體	shēntǐ	health; (human) body
黑	黑	hēi	black; dark (Kangxi radical 203); Heilongjiang province (abbreviation)
咖啡	咖啡	kāfēi	coffee
日	日	rì	sun; day; date; time (Kangxi radical 72)
休息	休息	xiūxi	to rest; take a break
外	外	wài	outer; outside; in addition; foreign
生日	生日	shēngrì	birthday
哥哥	哥哥	gēge	older brother
票	票	piào	ticket; bank note; a vote
手机	手機	shǒujī	mobile (cell) phone
洗	洗	xǐ	to wash; bathe
跳舞	跳舞	tiào wǔ	to dance
弟弟	弟弟	dìdi	younger brother
妹妹	妹妹	mèimei	younger sister
红	紅	hóng	red; symbol of success; bonus; popular
慢	慢	màn	slow
近	近	jìn	near; close (to)
白	白	bái, bó	white; snowy; pure; bright; empty (Kangxi radical 106)
姐姐	姐姐	jiějie	older sister
介绍	介紹	jièshào	to introduce; recommend; introduction
鱼	魚	yú	fish (Kangxi radical 195)
累	累	lèi, lěi, léi	tired | accumulate; implicate | rope; bind together
课	課	kè	class; subject; lesson; course
上班	上班	shàng bān	go to work; be on duty
旁边	旁邊	pángbiān	side, beside
运动	運動	yùndòng	(physical) exercise; movement; sports; campaign
去年	去年	qùnián	last year
报纸	報紙	bàozhǐ	newspaper
颜色	顏色	yánsè	color
机场	機場	jīchǎng	airport; airfield
唱歌	唱歌	chànggē	sing (a song)
千	千	qiān	one thousand
好吃	好吃	hǎochī	tasty
考试	考試	kǎoshì	test; exam; to give or take a test
左边	左邊	zuǒbian	the left side; the left
姓	姓	xìng	surname; family name
百	百	bǎi	hundred
雪	雪	xuě	snow
贵	貴	guì	expensive; noble; honorable; Guizhou province (abbreviation)
生病	生病	shēng bìng	get sick; fall ill
游泳	游泳	yóuyǒng	to swim
牛奶	牛奶	niúnǎi	cow's milk
右边	右邊	yòubian	the right (as opposed to left) side
便宜	便宜	piányi	cheap
公共汽车	公共汽車	gōnggòng qìchē	(public) bus
起床	起床	qǐ chuáng	get out of bed
打篮球	打籃球	dǎ lánqiú	play basketball
鸡蛋	雞蛋	jīdàn	(chicken) egg
踢足球	踢足球	tīzúqiú	to play football/soccer
零	零	líng	zero; remnant
手表	手表	shǒubiǎo	wristwatch
旅游	旅游	lǚyóu	trip; journey; tour
服务员	服務員	fúwùyuán	waiter/waitress; server; attendant
宾馆	賓館	bīnguǎn	guesthouse; hotel
教室	教室	jiàoshì	classroom
跑步	跑步	pǎo bù	to run; to jog
阴	陰	yīn	cloudy (weather); yin (the negative principle of Yin and Yang); secret; the moon; negative; shade
面条	面條	miàntiáo	noodles
铅笔	鉛筆	qiānbǐ	pencil
火车站	火車站	huǒchēzhàn	train station
西瓜	西瓜	xīguā	watermelon
羊肉	羊肉	yángròu	mutton; lamb
晴	晴	qíng	clear; fine (as of weather)
