SIMPLIFIED	TRADITIONAL	PINYIN	TRANSLATION
得	得	dé, děi, de	obtain | must | (complement particle)
死	死	sǐ	to die; dead; fixed; impassible; extremely
干	干	gàn, gān	to work; do; manage; tree trunk | to concern; shield; dry; clean (Kangxi radical 51)
而	而	ér	and; but; yet; while (Kangxi radical 126)
等	等	děng	to wait; rank; equal; etc.
当	當	dāng, dàng	should; act as; work as; manage; match; (sound of bells) | appropriate; assume; pawn
所有	所有	suǒyǒu	all; to have; to possess
也许	也許	yěxǔ	perhaps; probably; maybe
行	行	xíng, háng	walk; be current; do; will do; okay | row; place; a firm (Kangxi radical 144)
不过	不過	búguò	only; merely; but; however
发生	發生	fāshēng	happen; occur; take place
一切	一切	yíqiè	all; every; everything
抱	抱	bào	to hold; to hug; carry in one's arms; to cradle
抱歉	抱歉	bàoqiàn	be sorry; feel apologetic; to regret
感觉	感覺	gǎnjué	to feel; become aware of; feeling
肯定	肯定	kěndìng	sure; definite; affirm; approve
棒	棒	bàng	stick; club; good; excellent
以	以	yǐ	to use; according to; so as to; for; by
以为	以為	yǐwéi	think (mistakenly); consider (that); believe
掉	掉	diào	to drop; to fall
生活	生活	shēnghuó	life; livelihood; to live
之	之	zhī	(literary equivalent to 的); (pronoun); of
任何	任何	rènhé	any; whatever; whichever
与	與	yǔ, yù, yú	(formal) and; to give; together with; participate; final particle expressing doubt or surprise
弄	弄	nòng, lòng	do; manage; to handle; make | lane; alley
却	卻	què	but; yet; however
继续	繼續	jìxù	to continue; to go on; to proceed
够	夠	gòu	enough; to reach
父亲	父親	fùqin	father
完全	完全	wánquán	complete; whole; totally
可是	可是	kěshì	but; however
谈	談	tán	to talk; to chat; discuss
好像	好像	hǎoxiàng	as if; seem to be
警察	警察	jǐngchá	police
场	場	chǎng, cháng	courtyard; place; field; (mw for games, performances, etc.) | threshing floor
刚	剛	gāng	just (indicating the immediate past); recently; firm
呀	呀	ya, yā	ah; oh; (used for 啊 after words ending with a, e, i, o, or ü)
情况	情況	qíngkuàng	circumstance; state of affairs; situation
只要	隻要	zhǐyào	so long as; if only; provided that
份	份	fèn	part; portion; (mw for documents, papers, jobs, etc.)
底	底	dǐ	bottom; background; base
到底	到底	dào dǐ	after all; in the end (used in a question)
成为	成為	chéngwéi	become; turn into
永远	永遠	yǒngyuǎn	forever; eternal; always
安全	安全	ānquán	safe; safety; secure; security
留	留	liú	to leave (behind, a message); to retain; to stay
计划	計劃	jìhuà	plan; project
俩	倆	liǎ, liǎng	(colloquial) two (people)
停	停	tíng	to stop; to halt; to park (a car)
感谢	感謝	gǎnxiè	thank; be grateful
敢	敢	gǎn	to dare
从来	從來	cónglái	have always (from the beginning); never (with negative)
赢	贏	yíng	to win; to beat; to profit
消息	消息	xiāoxi	news; information
拉	拉	lā, lá	to pull; to play (string instruments); to drag | to slash; to chat
原因	原因	yuányīn	cause; reason
连	連	lián	even; including; join
确实	確實	quèshí	indeed; in truth; reliable
挺	挺	tǐng	straighten up; stick out; rather (good); very
保证	保証	bǎozhèng	to guarantee; ensure
接受	接受	jiēshòu	accept; receive (honors, etc.)
改变	改變	gǎibiàn	to change; alter; to transform
麻烦	麻煩	máfan	trouble (someone); troubling; bothersome
出现	出現	chūxiàn	appear; arise; emerge
不管	不管	bùguǎn	no matter (what, how, etc.); regardless of
甚至	甚至	shènzhì	even (to the point of); so much so that
保护	保護	bǎohù	to protect; to defend
真正	真正	zhēnzhèng	genuine; real; true
结果	結果	jiéguǒ	result; outcome; finally
当时	當時	dāngshí	then; at that time; while
至少	至少	zhìshǎo	at least; (to say the) least
律师	律師	lǜshī	lawyer
表演	表演	biǎoyǎn	perform; to play
无	無	wú	have not; without; not (Kangxi radical 71)
猜	猜	cāi	to guess
咱们	咱們	zánmen	we (including the listener); us; our
进行	進行	jìnxíng	carry on; carry out; undertake
内	內	nèi	inside; inner; internal; within
是否	是否	shìfǒu	whether (or not); if
调查	調查	diàochá	investigate; survey; inquiry
成功	成功	chénggōng	success; to succeed
考虑	考慮	kǎolǜ	think over; consider
约会	約會	yuēhuì	appointment; engagement; date
通过	通過	tōngguò	by means of; through (a method); pass through; via
开心	開心	kāixīn	feel happy; have a great time; make fun of somebody
母亲	母親	mǔqin	mother
主意	主意	zhǔyi	plan; idea; decision
倒	倒	dǎo, dào	to collapse; to fall; fail; to exchange | to pour; contrary to expectations
解释	解釋	jiěshì	to explain
联系	聯系	liánxì	integrate; link; connection; contact
证明	証明	zhèngmíng	proof; testify; confirm; certificate
生命	生命	shēngmìng	life
难道	難道	nándào	could it be that ...?; don't tell me ...
由	由	yóu	follow; from; by; through
指	指	zhǐ	finger; to point (at, to, out); refer to
危险	危險	wēixiǎn	danger; dangerous; perilous
讨厌	討厭	tǎoyàn	to hate; loathe; disgusting; troublesome
醒	醒	xǐng	wake up
样子	樣子	yàngzi	manner; air; appearance; looks
有趣	有趣	yǒuqù	interesting; fascinating; amusing
提	提	tí	to carry; to lift; to raise (an issue)
部分	部分	bùfen	part; share; section
理解	理解	lǐjiě	comprehend; understand
重	重	zhòng, chóng	heavy; serious; important | repeat; again; overlap
任务	任務	rènwu	a mission; an assignment; a task
使	使	shǐ	to use; to make; to cause; enable; envoy; messenger
转	轉	zhuǎn, zhuàn	to turn; to change; pass on | revolve; rotate
博士	博士	bóshì	doctor; PhD
紧张	緊張	jǐnzhāng	nervous; tension; strain
放弃	放棄	fàngqì	abandon; renounce; give up
大概	大概	dàgài	probably; roughly; approximate
重新	重新	chóngxīn	again; anew; once more
其中	其中	qízhōng	among; in; included among these
来自	來自	láizì	come from (a place)
本来	本來	běnlái	originally; at first
并且	並且	bìngqiě	and; besides; moreover
直接	直接	zhíjiē	direct; immediate
对于	對於	duìyú	regarding; as far as sth. is concerned; with regards to; for
正常	正常	zhèngcháng	normal; regular; ordinary
遍	遍	biàn	a time; everywhere; turn; (mw for times or turns)
冷静	冷靜	lěngjìng	calm; cool-headed; sober
方法	方法	fāngfǎ	method; way; means
扔	扔	rēng	to throw; throw away
能力	能力	nénglì	capability; capable; ability
另外	另外	lìngwài	another; in addition; besides
放松	放鬆	fàngsōng	relax; loosen; slacken
丢	丟	diū	lose (something); throw; put aside
负责	負責	fùzé	responsible for (something); in charge of
梦	夢	mèng	to dream
戴	戴	dài	put on; to wear; to respect
错误	錯誤	cuòwù	error; mistake; mistaken
随便	隨便	suíbiàn	as one pleases; informal; random; casual
经历	經歷	jīnglì	undergo; to experience
支持	支持	zhīchí	sustain; hold out; | support; stand by (e.g. international support)
建议	建議	jiànyì	to propose; to suggest; recommend
否则	否則	fǒuzé	if not; otherwise; or else
光	光	guāng	light; ray; bright; only; merely; used up
安排	安排	ānpái	arrange; to plan
钥匙	鑰匙	yàoshi	key
信息	信息	xìnxī	information; news; message
全部	全部	quánbù	whole; entire; complete
首先	首先	shǒuxiān	first (of all); in the first place; firstly
照	照	zhào	to shine; illuminate; according to
交	交	jiāo	deliver; turn over; intersect; to pay (money); friendship
台	台	tái	platform; Taiwan (abbr.); desk; stage; typhoon; (mw for machines); (classical) you (in letters)
坚持	堅持	jiānchí	persist in; persevere
生意	生意	shēngyi	business; trade
火	火	huǒ	fire (Kangxi radical 86)
即使	即使	jíshǐ	even if; even though
到处	到處	dàochù	everywhere; in all places; all over
挂	挂	guà	hang; put up; suspend
道歉	道歉	dàoqiàn	apologize; make an apology
可怜	可憐	kělián	pitiful; poor; pathetic
实在	實在	shízài	honest; in reality; honestly; indeed; certainly
骗	騙	piàn	to cheat; to swindle; deceive
原谅	原諒	yuánliàng	to excuse; forgive; to pardon
乱	亂	luàn	disorder; confusion; arbitrarily
差不多	差不多	chàbuduō	almost; about the same
满	滿	mǎn	full; abbreviation for Manchurian
假	假	jiǎ, jià	fake; if; borrow | vacation; holiday
研究	研究	yánjiū	to study; to research
打扰	打擾	dǎrǎo	disturb
正确	正確	zhèngquè	correct; proper
收	收	shōu	receive; accept; collect; to harvest
秒	秒	miǎo	second (unit of time or angle)
同时	同時	tóngshí	at the same time; simultaneously
提供	提供	tígōng	to supply; provide; furnish
输	輸	shū	to transport; to lose (a game, etc.)
号码	號碼	hàomǎ	number
座	座	zuò	(mw for mountains, bridges, tall buildings, etc.); | seat; base; stand; constellation
比如	比如	bǐrú	for example; for instance; such as
严重	嚴重	yánzhòng	grave; serious; critical
脱	脫	tuō	to shed; take off; to escape
陪	陪	péi	accompany; keep company
法律	法律	fǎlǜ	law; statute
值得	值得	zhíde	be worth; deserve
使用	使用	shǐyòng	to use; employ; apply; administer; manipulate
方面	方面	fāngmiàn	aspect; field; side
原来	原來	yuánlái	original; former; as it turns out
讨论	討論	tǎolùn	to discuss; discussion; to talk over
说明	說明	shuōmíng	explain; explanation; illustrate; to show
仍然	仍然	réngrán	still; yet
动作	動作	dòngzuò	movement; motion; action
受到	受到	shòudào	receive (influence, restriction, etc.); be subjected to
赶	趕	gǎn	catch up; overtake; drive away
怀疑	懷疑	huáiyí	doubt; to suspect; be skeptical
拒绝	拒絕	jùjué	to refuse; to decline; to reject
演员	演員	yǎnyuán	actor or actress; performer
破	破	pò	broken; damaged; to split
因此	因此	yīncǐ	therefore; thus; that is why; because of this
答案	答案	dá'àn	answer; solution
活动	活動	huódòng	activity; exercise; move about
既然	既然	jìrán	since; given that; now that
通知	通知	tōngzhī	notify; to inform; notice
不得不	不得不	bù dé bù	have to; have no choice but to; cannot but
无论	無論	wúlùn	no matter what; regardless of whether...
刀	刀	dāo	knife; blade (Kangxi radical 18)
适合	適合	shìhé	to suit; to fit
失望	失望	shīwàng	disappointed; lose hope
允许	允許	yǔnxǔ	to permit; allow
意见	意見	yìjiàn	opinion; view; suggestion; complaint
获得	獲得	huòdé	obtain; acquire; to gain
要是	要是	yàoshi	if; suppose; in case
邀请	邀請	yāoqǐng	to invite
尽管	盡管	jǐnguǎn	despite; although; even though | freely; without hesitation
浪费	浪費	làngfèi	to waste; squander
失败	失敗	shībài	be defeated; fail; lose
责任	責任	zérèn	responsibility; blame; duty
美丽	美麗	měilì	beautiful
压力	壓力	yālì	pressure; stress
味道	味道	wèidao	flavor; taste
厉害	厲害	lìhai	terrible; formidable; fierce; cool; awesome
出发	出發	chūfā	start out; set off
兴奋	興奮	xīngfèn	excitement; be excited
观众	觀眾	guānzhòng	spectator; audience
反对	反對	fǎnduì	oppose; fight against
精彩	精彩	jīngcǎi	brilliant; spectacular; wonderful
感情	感情	gǎnqíng	feeling; emotion; sensation
演出	演出	yǎnchū	to act (in a play); to perform; to put on a show; performance
愉快	愉快	yúkuài	happy; cheerful; delightful
开玩笑	開玩笑	kāi wánxiào	joke; play a joke; make fun of
杂志	雜志	zázhì	magazine
合适	合適	héshì	suitable; proper; appropriate
广告	廣告	guǎnggào	advertisement; a commercial
自然	自然	zìrán	nature; natural
深	深	shēn	deep; profound; dark (of colors)
取	取	qǔ	to take; get; choose
短信	短信	duǎnxìn	text message; SMS
地球	地球	dìqiú	the Earth; planet
帅	帥	shuài	handsome; graceful; commander-in-chief
推	推	tuī	to push; to scrape; to decline; postpone; elect
关键	關鍵	guānjiàn	crucial; key; pivotal
空	空	kōng, kòng	empty; sky | leave blank; leisure
究竟	究竟	jiūjìng	after all; when all is said and done; actually
恐怕	恐怕	kǒngpà	be afraid; to fear; I'm afraid that...
躺	躺	tǎng	recline; lie down (on back or side)
聚会	聚會	jùhuì	hold a meeting; get together; a party
方向	方向	fāngxiàng	direction; orientation
幸福	幸福	xìngfú	happy; blessed; fortunate
接着	接著	jiēzhe	continue; carry on; to catch; follow
技术	技術	jìshù	technology; technique; skill
困	困	kùn	sleepy; surround; hard-pressed
困难	困難	kùnnan	difficulty; difficult; problem
正好	正好	zhènghǎo	just (in time); just right; just enough; happen to; by chance
提醒	提醒	tíxǐng	remind; call attention to; warn of
旅行	旅行	lǚxíng	travel
激动	激動	jīdòng	excite; agitate
骄傲	驕傲	jiāo'ào	proud; arrogant; conceited; take pride in
毛	毛	máo	hair; fur; feather; dime (Kangxi radical 82)
节	節	jié	section; part; festival; moral integrity; save; (mw for class periods)
许多	許多	xǔduō	many; a lot; much
顺利	順利	shùnlì	go smoothly; without a hitch; successful
职业	職業	zhíyè	profession; occupation
赚	賺	zhuàn, zuàn	earn; make a profit | to cheat; to swindle
地址	地址	dìzhǐ	address
于是	於是	yúshì	as a result; thus; therefore
收拾	收拾	shōushi	to tidy; put in order; to repair; to settle with; punish
周围	周圍	zhōuwéi	surroundings; vicinity; environment
爱情	愛情	àiqíng	(romantic) love
尊重	尊重	zūnzhòng	esteem; to respect; to value; to honor
十分	十分	shífēn	very; fully; 100%
教授	教授	jiàoshòu	professor; instruct; to lecture
超过	超過	chāoguò	surpass; exceed; outstrip
寄	寄	jì	send by mail
顺便	順便	shùnbiàn	conveniently; in passing; on the way
无聊	無聊	wúliáo	nonsense; bored; silly; stupid
目的	目的	mùdì	purpose; aim; goal
低	低	dī	low; to lower (one's head); droop
剩	剩	shèng	have as remainder; be left over; surplus
复杂	復雜	fùzá	complicated; complex
社会	社會	shèhuì	society
故意	故意	gùyì	deliberately; intentional; on purpose
好处	好處	hǎochu	benefit; advantage
竟然	竟然	jìngrán	unexpectedly; to one's surprise; go so far as to
表示	表示	biǎoshì	express; show; indicate
印象	印象	yìnxiàng	impression
出生	出生	chūshēng	be born
估计	估計	gūjì	appraise; estimate
地点	地點	dìdiǎn	place; site; location
轻	輕	qīng	light; easy; gentle; soft
轻松	輕鬆	qīngsōng	relaxed; gentle; easygoing
作用	作用	zuòyòng	action; activity; effect
举	舉	jǔ	lift; raise; cite
小伙子	小伙子	xiǎohuǒzi	young man; lad; youngster
著名	著名	zhùmíng	famous; well-known; celebration
免费	免費	miǎn fèi	free (of charge); no cost
伤心	傷心	shāngxīn	sad; grieve; brokenhearted
记者	記者	jìzhě	reporter; journalist
仔细	仔細	zǐxì	careful; attentive; cautious
巧克力	巧克力	qiǎokèlì	chocolate
辣	辣	là	hot (spicy)
互相	互相	hùxiāng	mutually; with each other
厕所	廁所	cèsuǒ	bathroom; toilet; lavatory
过程	過程	guòchéng	course of events; process
申请	申請	shēnqǐng	apply for; application
引起	引起	yǐnqǐ	give rise to; lead to; to cause; arouse
发展	發展	fāzhǎn	develop; development; growth
毕业	畢業	bì yè	to graduate; to finish school
正式	正式	zhèngshì	formal; official
厨房	廚房	chúfáng	kitchen
专业	專業	zhuānyè	profession; specialized field of study; major
吸引	吸引	xīyǐn	attract (interest, investment, etc.)
心情	心情	xīnqíng	mood; state of mind
祝贺	祝賀	zhùhè	congratulate
条件	條件	tiáojiàn	condition; circumstances; prerequisite
千万	千萬	qiānwàn	ten million; be sure to; must
糖	糖	táng	sugar; candy; sweets
趟	趟	tàng, tāng	(mw for trips times) | to wade
由于	由於	yóuyú	due to; owing to; as a result of; thanks to
密码	密碼	mìmǎ	password; secret code
倍	倍	bèi	(two, three, etc)-fold; times (multiplier)
擦	擦	cā	to wipe; to rub; to polish
尤其	尤其	yóuqí	especially; particularly
经验	經驗	jīngyàn	experience
盒子	盒子	hézi	box
干杯	干杯	gān bēi	to drink a toast; cheers!; bottoms up!
看法	看法	kànfǎ	point of view; opinion
脏	臟	zāng, zàng	filthy; dirty | internal organs; viscera
艺术	藝術	yìshù	art
速度	速度	sùdù	speed; rate; velocity
勇敢	勇敢	yǒnggǎn	brave; courageous
数字	數字	shùzì	number; numeral; figure; digit
暂时	暫時	zànshí	temporary; transient; for the moment
优秀	優秀	yōuxiù	outstanding; excellent
笑话	笑話	xiàohua	joke; laugh at
可惜	可惜	kěxī	it's a pity; regrettable; too bad
响	響	xiǎng	make a sound; to ring; echo
省	省	shěng, xǐng	to save; economize; omit; province | examine oneself; to visit; be aware
笨	笨	bèn	stupid; foolish; silly; dumb; clumsy
科学	科學	kēxué	science; scientific knowledge
餐厅	餐廳	cāntīng	dining hall; cafeteria; restaurant
各	各	gè	each; every
距离	距離	jùlí	distance; be apart; away from
窗户	窗戶	chuānghu	window
空气	空氣	kōngqì	air
护士	護士	hùshi	nurse
后悔	后悔	hòuhuǐ	to regret; repent
大约	大約	dàyuē	approximately; about
内容	內容	nèiróng	content; substance; details
规定	規定	guīdìng	regulation; stipulate; fix; set
效果	效果	xiàoguǒ	effect; result
现金	現金	xiànjīn	cash
儿童	兒童	értóng	child; children
租	租	zū	to rent
篇	篇	piān	sheet; (mw for articles); piece of writing
浪漫	浪漫	làngmàn	romantic
态度	態度	tàidu	manner; bearing; attitude
自信	自信	zìxìn	self-confidence
吃惊	吃驚	chī jīng	be startled; be shocked; be amazed
熟悉	熟悉	shúxī	familiar with; know well
按照	按照	ànzhào	according to; in accordance with; in light of
世纪	世紀	shìjì	century
回忆	回憶	huíyì	to recall; recollect
相同	相同	xiāngtóng	identical; same; alike
重点	重點	zhòngdiǎn	emphasis; main point
教育	教育	jiàoyù	education
受不了	受不了	shòu bu liǎo	cannot endure; unbearable; can't stand
皮肤	皮膚	pífū	skin
区别	區別	qūbié	difference; distinguish
左右	左右	zuǒyòu	about; approximate; around | left and right
阳光	陽光	yángguāng	sunshine; sunlight
页	頁	yè	page; leaf (Kangxi radical 181)
文章	文章	wénzhāng	article; essay
语言	語言	yǔyán	language
标准	標准	biāozhǔn	(an official) standard; norm; criterion
管理	管理	guǎnlǐ	supervise; manage
误会	誤會	wùhuì	to misunderstand; to mistake
桥	橋	qiáo	bridge
举行	舉行	jǔxíng	convene; to hold (a meeting, ceremony, etc.)
肚子	肚子	dùzi	belly; abdomen; stomach
不仅	不僅	bùjǐn	not only; not just
饼干	餅干	bǐnggān	biscuit; cracker; cookie
国际	國際	guójì	international
信心	信心	xìnxīn	confidence; faith (in sb. or sth.)
抬	抬	tái	to lift; to raise (with both palms up); carry (together)
竞争	競爭	jìngzhēng	compete
汤	湯	tāng	soup; broth
作家	作家	zuòjiā	author; writer
诚实	誠實	chéngshí	honest; honorable
顾客	顧客	gùkè	customer; client
存	存	cún	exist; to deposit; to store
香	香	xiāng	fragrant; savory (Kangxi radical 186)
打扮	打扮	dǎban	dress up; put on make up
交流	交流	jiāoliú	communicate; exchange; give and take; interaction; to alternate
年龄	年齡	niánlíng	(a person's) age
小说	小說	xiǎoshuō	novel; fiction
符合	符合	fúhé	in keeping with; in accordance with; conform
交通	交通	jiāotōng	traffic; transportation
共同	共同	gòngtóng	together; common; joint
稍微	稍微	shāowēi	a little bit; slightly
增加	增加	zēngjiā	to increase; to raise; add
敲	敲	qiāo	knock; blackmail
适应	適應	shìyìng	to suit; to fit; adapt
苦	苦	kǔ	bitter; miserable
辛苦	辛苦	xīnkǔ	hard; exhausting; toilsome; laborious
然而	然而	rán'ér	however; yet; but
耐心	耐心	nàixīn	to be patient
将来	將來	jiānglái	the future
沙发	沙發	shāfā	sofa
最好	最好	zuìhǎo	the best; had better ...; it would be best
禁止	禁止	jìnzhǐ	to ban; prohibit
经济	經濟	jīngjì	economy; economic
座位	座位	zuòwèi	seat; place
购物	購物	gòuwù	go shopping; buy goods
抽烟	抽煙	chōuyān	to smoke (a cigarette, pipe, etc.)
航班	航班	hángbān	scheduled flight; flight number
礼貌	禮貌	lǐmào	courtesy; politeness; manners
提前	提前	tíqián	shift to an earlier date; bring forward; to advance
判断	判斷	pànduàn	to judge; judgment; to decide
胳膊	胳膊	gēbo	arm
整理	整理	zhěnglǐ	put in order; arrange; straighten up; to tidy; to pack (luggage)
森林	森林	sēnlín	forest
同情	同情	tóngqíng	compassion; sympathy
网站	網站	wǎngzhàn	website
商量	商量	shāngliang	consult; talk over; discuss
眼镜	眼鏡	yǎnjìng	glasses; spectacles
镜子	鏡子	jìngzi	mirror
广播	廣播	guǎngbō	broadcast; on the air
专门	專門	zhuānmén	specialized
弹钢琴	彈鋼琴	tán gāngqín	play the piano
尝	嘗	cháng	to taste; flavor; (past tense marker)
流行	流行	liúxíng	spread; prevalent; be popular
材料	材料	cáiliào	material
对话	對話	duìhuà	dialogue; conversation
详细	詳細	xiángxì	detailed; in detail; minute
随着	隨著	suízhe	along with; in the wake of
降落	降落	jiàngluò	descend; to land; put down
功夫	功夫	gōngfu	kung fu; skill; art; labor
严格	嚴格	yángé	strict; stringent; tight
日记	日記	rìjì	diary
偶尔	偶爾	ǒu'ěr	occasionally; once in a while; sometimes
实际	實際	shíjì	actual; reality; practice
友好	友好	yǒuhǎo	friendly (relations); close friends
相反	相反	xiāngfǎn	opposite; contrary
大夫	大夫	dàifu	doctor; physician
友谊	友誼	yǒuyì	friendship; companionship
准确	准確	zhǔnquè	accurate; precise
平时	平時	píngshí	ordinarily; in normal times; in peacetime
对面	對面	duìmiàn	opposite; across from; the other side
脾气	脾氣	píqi	temperament; disposition; temper
价格	價格	jiàgé	price
性格	性格	xìnggé	nature; personality; temperament
鼓励	鼓勵	gǔlì	encourage; inspire
及时	及時	jíshí	timely; in time; promptly; without delay
迷路	迷路	mílù	to get lost
棵	棵	kē	(mw for plants)
理想	理想	lǐxiǎng	ideal
工资	工資	gōngzī	wages; pay; earnings; salary
散步	散步	sàn bù	to go for a walk
只好	隻好	zhǐhǎo	have to; be forced to
感动	感動	gǎndòng	be moved; to touch emotionally
知识	知識	zhīshi	knowledge; intellectual
难受	難受	nánshòu	feel unwell; to suffer pain
奖金	獎金	jiǎngjīn	bonus
幽默	幽默	yōumò	humorous
孙子	孫子	sūnzi	grandson; son's son
汗	汗	hàn, hán	sweat; perspiration; Khan
收入	收入	shōurù	take in; income; revenue
酸	酸	suān	sour; sore; ache
公里	公裡	gōnglǐ	kilometer
害羞	害羞	hài xiū	blush; shy
基础	基礎	jīchǔ	base; foundation
准时	准時	zhǔnshí	punctually; on time
积极	積極	jījí	active; positive; energetic
富	富	fù	wealthy
力气	力氣	lìqi	physical strength; effort
入口	入口	rùkǒu	entrance
袜子	襪子	wàzi	socks; stockings
烦恼	煩惱	fánnǎo	worried; vexed
举办	舉辦	jǔbàn	to conduct; to hold
修理	修理	xiūlǐ	to repair; perform maintenance; to overhaul
减少	減少	jiǎnshǎo	reduce; to decrease
亲戚	親戚	qīnqi	a relative (i.e. family relation)
参观	參觀	cānguān	to visit (a place, such as a tourist spot); inspect
丰富	豐富	fēngfù	rich; enrich; abundant; plentiful
果汁	果汁	guǒzhī	fruit juice
毛巾	毛巾	máojīn	towel; washcloth
作者	作者	zuòzhě	author; writer
海洋	海洋	hǎiyáng	ocean
批评	批評	pīpíng	criticize
排队	排隊	pái duì	queue; stand in line
例如	例如	lìrú	for example; for instance
植物	植物	zhíwù	plant; botanical; vegetation
穷	窮	qióng	poor; exhausted
家具	家具	jiājù	furniture
盐	鹽	yán	salt
温度	溫度	wēndù	temperature
数量	數量	shùliàng	amount; quantity; number
逛	逛	guàng	to stroll; to visit; go window shopping
厚	厚	hòu	thick (for flat things); generous
亚洲	亞洲	Yàzhōu	Asia
来不及	來不及	lái bu jí	there's not enough time (to do something); it's too late
师傅	師傅	shīfu	master; qualified worker; teacher
污染	污染	wūrǎn	pollution; contamination
来得及	來得及	lái de jí	there's still time
减肥	減肥	jiǎnféi	go on a diet; lose weight
客厅	客廳	kètīng	living room; parlor
缺少	缺少	quēshǎo	to lack; be short of; be deficient in
老虎	老虎	lǎohǔ	tiger
降低	降低	jiàngdī	reduce; to lower; to drop
云	雲	yún	cloud; Yunnan province | say; speak
质量	質量	zhìliàng	quality; mass (physics)
学期	學期	xuéqī	semester; school term
卫生间	衛生間	wèishēngjiān	restroom; bathroom; water closet (WC)
网球	網球	wǎngqiú	tennis; tennis ball
其次	其次	qícì	next; secondly
打招呼	打招呼	dǎzhāohu	notify; greet; inform
表格	表格	biǎogé	form (document)
阅读	閱讀	yuèdú	read; reading
信封	信封	xìnfēng	envelope
顺序	順序	shùnxù	sequence; order
放暑假	放暑假	fàng shǔjià	have summer vacation
乘坐	乘坐	chéngzuò	ride; get into (a vehicle)
重视	重視	zhòngshì	to value; take seriously
推迟	推遲	tuīchí	postpone; defer
缺点	缺點	quēdiǎn	weak point; defect; fault; shortcoming
加油站	加油站	jiāyóuzhàn	gas station
首都	首都	shǒudū	capital (city)
羡慕	羨慕	xiànmù	to envy; admire
零钱	零錢	língqián	small change (of money)
暖和	暖和	nuǎnhuo	warm; nice and warm
懒	懶	lǎn	lazy
出差	出差	chū chāi	go on a business trip
民族	民族	mínzú	nationality; ethnic group
传真	傳真	chuánzhēn	fax; facsimile
优点	優點	yōudiǎn	merit; good point; a strength; a benefit
垃圾桶	垃圾桶	lājītǒng	garbage can
加班	加班	jiā bān	work overtime
房东	房東	fángdōng	landlord
按时	按時	ànshí	on time; on schedule
葡萄	葡萄	pútao	grape
往往	往往	wǎngwǎng	often; frequently; more often than not
高速公路	高速公路	gāosù gōnglù	highway
得意	得意	déyì	proud of oneself; complacent
特点	特點	tèdiǎn	a characteristic; trait; feature
合格	合格	hégé	qualified; up to standard
性别	性別	xìngbié	gender; sex; sexual distinction
报名	報名	bào míng	sign up; apply
互联网	互聯網	Hùliánwǎng	Internet
景色	景色	jǐngsè	scenery; landscape; scene; view
大使馆	大使館	dàshǐguǎn	embassy
总结	總結	zǒngjié	summarize; conclude
热闹	熱鬧	rènao	bustling; lively; busy
郊区	郊區	jiāoqū	suburbs; outskirts
咳嗽	咳嗽	késou	to cough
签证	簽証	qiānzhèng	visa
咸	咸	xián	salty; salted; all
打印	打印	dǎyìn	to print
活泼	活潑	huópo	lively; vivacious
邮局	郵局	yóujú	post office
牙膏	牙膏	yágāo	toothpaste
气候	氣候	qìhòu	climate; atmosphere; weather
勺子	勺子	sháozi	spoon; scoop; ladle
付款	付款	fù kuǎn	to pay
理发	理發	lǐfà	a barber, hairdressing; haircut
复印	復印	fùyìn	photocopy; duplicate
词语	詞語	cíyǔ	words and expressions; terms
表扬	表揚	biǎoyáng	to praise; commend
打针	打針	dǎzhēn	inject; get a shot
普遍	普遍	pǔbiàn	common; universal; general; widespread
堵车	堵車	dǔchē	traffic jam
叶子	葉子	yèzi	leaves
打折	打折	dǎzhé	sell at a discount
排列	排列	páiliè	arrange; align; permutation
凉快	涼快	liángkuai	nice and cool; pleasantly cool
塑料袋	塑料袋	sùliàodài	plastic bag
导游	導游	dǎoyóu	tour guide
小吃	小吃	xiǎochī	snack; refreshments
西红柿	西紅柿	xīhóngshì	tomato
招聘	招聘	zhāopìn	recruitment; take job applications for a job
节约	節約	jiéyuē	frugal; to save
硕士	碩士	shuòshì	Master's degree (M.A.)
乒乓球	乒乓球	pīngpāngqiú	ping pong; table tennis
积累	積累	jīlěi	accumulate; accumulation
橡皮	橡皮	xiàngpí	rubber; an eraser
应聘	應聘	yìngpìn	accept a job offer; to apply for a job
矿泉水	礦泉水	kuàngquánshuǐ	mineral water
长城	長城	chángchéng	the Great Wall
语法	語法	yǔfǎ	grammar
礼拜天	禮拜天	lǐbàitiān	Sunday
饺子	餃子	jiǎozi	dumpling; potsticker
国籍	國籍	guójí	nationality
售货员	售貨員	shòuhuòyuán	salesclerk; shop assistant
翻译	翻譯	fānyì	translate; translation; interpret
流利	流利	liúlì	fluent
粗心	粗心	cūxīn	careless; inadvertent; negligent
养成	養成	yǎngchéng	cultivate; acquire; to form
马虎	馬虎	mǎhu	careless; sloppy; casual
百分之	百分之	bǎifēnzhī	percent
普通话	普通話	pǔtōnghuà	Mandarin (common language)
登机牌	登機牌	dēngjīpái	boarding pass
占线	佔線	zhànxiàn	the (phone) line is busy
包子	包子	bāozi	steamed stuffed bun
羽毛球	羽毛球	yǔmáoqiú	badminton
烤鸭	烤鴨	kǎoyā	roast duck
寒假	寒假	hánjià	winter vacation
长江	長江	Chángjiāng	the Yangtze River; the Changjiang River
预习	預習	yùxí	(of students) prepare a lesson before class; preview
填空	填空	tiánkòng	fill in the blanks; fill a vacancy
京剧	京劇	jīngjù	Beijing Opera
