драматический	dramatic
дружить (i) (с +inst)	to be friends (with s.o.)	i дружу, дружишь
дурачок	idiot, half-wit
душный	stuffy
дымиться (i)	to smoke
дырка	small hole	g pl дырок
желающий	person interested (in doing sth)	Есть желающие пойти в кино? Does anyone want to go to the cinema?
желтоватый	yellowish
законченный	complete; consummate, professional	законченный мастер consummate master
запечатлевать/запечатлеть (+a)	to imprint	p запечатлею, запечатлеешь
затрагивать/затронуть (+a)	to touch, affect
шагать/за-	to stride out
зёрнышко	grain	nom pl зёрнышки, g pl зёрнышек
значимость (f)	significance	f
изгонять/изгнать (+a)	to expel, banish	p изгоню, изгонишь, f past изгнала
излюбленный	favourite
измеряться/измериться	to be measured	i измеряется
расходовать/израсходовать (+a)	to spend, use up	p израсходую
иллюминатор	porthole
иллюстрировать (i/p) (+a)	to illustrate	i/p иллюстрирую
именовать/на- (+a)	to name	i именую
инвентарь (m)	equipment; inventory	m; g sg инвентаря
интеллектуальный	intellectual (adj)
ископаемые	minerals
исполненный (+g)	full (of)
исправление	correction
истерика	hysterics
исчерпывающий	exhaustive
итальянец	Italian
канат	rope, cable
капиталовложение	capital investment	often pl капиталовложения
катить/по- (+a)	to roll (sth)	i качу, катишь
киевский	Kiev (adj)
кипяток	boiling water
классный	class (adj); first-class
клиника	clinic
коза	goat	nom pl козы
козырь (m)	trump	m; g pl козырей
коленка	knee (coll)	g pl коленок
колючий	prickly	колючая проволока barbed wire
комар	mosquito	g sg комара
комбинезон	overalls
комод	chest of drawers
конвейер	conveyor belt
конфисковать (i/p) (+a)	to confiscate	i/p конфискую
концертный	concert (adj)
концлагерь (m)	concentration camp	nom pl концлагеря
кончина	decease, demise (formal)
кооперативный	cooperative (adj)
копать/копнуть (+a)	to dig
косо	squint, askew
косточка	stone (of fruit); small bone	g pl косточек
котёнок	kitten	nom pl котята, g pl котят
красить/о-	to paint, colour; dye	i крашу, красишь; вы-/о-/по- р
красноватый	reddish
крах	crash; failure
крошка	crumb	g pl крошек
кряхтеть (i)	to groan; grunt	i кряхчу, кряхтишь
кузов	body (of vehicle); basket	nom pl кузова
культ	cult	культ личности cult of personality
лайнер	liner
лёгкое	lung
лениво	lazily
лечиться (i) (от +g)	to undergo treatment, be treated for	i лечусь, лечишься
линейка	line (on paper); ruler (for drawing lines)	g pl линеек
лондонский	London (adj)
лоскут	rag, scrap	nom pl лоскуты, g pl лоскутов or nom pl лоскутья, g pl лоскутьев
любезно	obligingly, courteously
макушка	top; crown (of head)	g pl макушек; Ушки на макушке I’m all ears
маневрировать/с-	to manoeuvre	i маневрирую
машинально	mechanically
машиностроительный	mechanical engineering (adj)
мелко	finely; pettily
мельком	in passing
метить (i)	(+a) to mark; (в +a) aim (at)	i мечу, метишь
мещанка	lower middle-class woman; philistine	g pl мещанок
многообразный	diverse
молва	rumour(s)	no pl
монумент	monument
морщинка	wrinkle	g pl морщинок
мраморный	marble (adj)
мужицкий	peasant (adj), peasant’s
наваливать/навалить (+a)	to heap up, pile	p навалю, навалишь
навечно	for ever
навоз	manure
наглухо	tightly, firmly
нагревать/нагреть (+a)	to warm, heat	p нагрею, нагреешь
надвигаться/надвинуться	to draw near
надобно	necessary (coll) (= надо)	= надо
нанимать/нанять (+a)	to hire
поить/на- (+a)	to give to drink	поить i/напаивать i; i пою, поишь
напоследок	in the end (coll)
наравне (с +inst)	level (with), on equal terms (with)
наскоро	hastily (coll)
настежь	wide open
научно	scientifically
недоверчиво	distrustfully, suspiciously
незабываемый	unforgettable
немыслимый	unthinkable
ненормальный	abnormal; mad
непобедимый	invincible
неполный	incomplete
непреклонный	unyielding, adamant
непреодолимый	insurmountable
неслышно	inaudible; inaudibly
неутомимый	tireless
нырять/нырнуть	to dive
обдумывать/обдумать (+a)	to consider, ponder, think over
оберегать/оберечь (+a от +g)	to protect (s.o. from sth)
обиход	use; custom, practice	выйти из обихода to go out of use
облачный	cloudy
обливать/облить (+a +inst)	to pour sth (inst) over sth	p оболью, обольёшь, f past облила
обложка	cover (of book etc.)	g pl обложек
обнажённый	naked
обобщение	generalization
образцовый	model, exemplary
обрушиваться/обрушиться	to collapse, cave in; (на +a) fall upon, attack (s.o. or sth)
одновременный	simultaneous
оживлённый	animated, excited
окрестный	surrounding
опаска	caution (coll)	с опаской nervously, cautiously
опровержение	refutation
опущенный	lowered
освободительный	liberation (adj)
осложнение	complication
осмысливать/осмыслить (+a)	to make sense (of sth), interpret
оставшийся	remaining
остроумный	witty
отбор	selection
отделяться/отделиться (от +g)	to separate (from)	i отделяюсь
откликаться/откликнуться (на +a)	to respond (to sth)
отовсюду	from everywhere
отрицание	negation
ощутимый	perceptible
ощущаться (i)	to be felt
панорама	panorama
парламентский	parliamentary
парта	school desk
паутина	cobweb
певица	singer f
первоначально	originally
перевал	crossing; mountain pass
переделка	alteration
перекрёсток	crossroads
перелив	tint; play of colours
перенимать/перенять (+a)	to copy, adopt	p перейму, переймёшь, past перенял, переняла, переняло
пересадка	change (of transport); transplant(ation)	g pl пересадок
переспрашивать/переспросить (+a)	to ask again	p переспрошу, переспросишь
периодический	periodic, recurrent
пирожок	pie
плавно	smoothly
плавучий	floating
плодотворный	fruitful
повествование	narration
повиноваться (i/p) (+d)	to obey	i повинуюсь; повиноваться р (past only)
поводить/повести (+inst)	to move, twitch	i повожу, поводишь
пограничный	border (adj)
подвешивать/подвесить (+a)	to suspend	p подвешу, подвесишь
поддержание	support, maintenance
подлежать (i) (+d)	to be subject to	i подлежит; Это не подлежит сомнению This is indisputable
подозрительный	suspicious
подолгу	for a long time
по-другому	differently
подружиться (р) (с +inst)	to make friends with	p подружусь, подружишься
подскакивать/подскочить	to run up; jump up	p подскочу, подскочишь
подступ (к +d)	approach
подтверждаться/подтвердиться	to be confirmed
подчас	sometimes
поединок	duel
поинтересоваться (р) (+inst)	to take an interest, wonder	(p) поинтересуюсь
полированный	polished
политбюро	Politburo	n indecl
политически	politically
положительно	positively
помеха	hindrance
понедельник	Monday
пить/по-	to have a drink	p попью, попьёшь, f past попила
порочный	vicious; defective
поспевать/поспеть (к +d/нa +a)	to be in time for; ripen (coll), be on time; keep up with	p поспею, поспеешь
посредство	mediation
посыпаться (i/p)	to pour down	p посыплется
по-твоему	in your opinion; as you want it
потирать/потереть (+a)	to rub
тревожить/по- (+a)	to trouble
поучать (i) (+a)	to lecture (s.o.)	i
щадить/по- (+a)	to spare	i щажу, щадишь; p пощажу, пощадишь
преграда	obstacle
предисловие	foreword
предотвращение	prevention
предшествовать (i) (+d)	to precede	i предшествует
пренебрегать/пренебречь (+inst)	to scorn (s.o. or sth)
прения (n pl)	debate, discussion	n pl; g pl прений
прибрежный	coastal; riverside
прививать/привить (+a)	to inoculate; inculcate	p привью, привьёшь, past привила
приз	prize	nom pl призы
прикреплять/прикрепить (+a к +d)	to fasten (sth to sth)	p прикреплю, прикрепишь
примета	sign
присваивать/присвоить (+a)	to take over, appropriate; award, confer (sth on s.o.)
присматривать/присмотреть (за +inst)	to look after, supervise
пристальный	fixed, constant
присутствующий	present, (as noun) person present
приучать/приучить (+inf or к +d)	to train (to do sth)	p приучу, приучишь
причёска	hairstyle	g pl причёсок
причудливый	odd, whimsical
проповедовать (i) (+a)	to preach; advocate	i проповедую
прорываться/прорваться	to break through; tear	p прорвусь, прорвёшься, past прорвался, прорвалась
прорезывать/прорезать (+a)	to cut through	p проре́зать, проре́жу, проре́жешь; прореза́ть i/проре́зывать i
просвечивать (i)	to be translucent; shine through
прославлять/прославить (+a)	to make famous	p прославлю, прославишь
простаивать/простоять	to stand idle
простыня	sheet (bedding)	nom pl простыни, g pl простынь, d pl простыням
протокол	protocol; minutes (of meeting)
процедура	procedure
птичка	small bird; tick	g pl птичек
пульс	pulse
пускай	let (= пусть) (coll)	Пускай говорит Let him speak
пустырь (m)	waste ground	g sg пустыря
пылать (i)	to blaze	i
радикальный	radical
радужный	iridescent; radiant
разбег	run
разбой	banditry
разбойничий	robber’s, brigand’s	f разбойничья, n разбойничье
разводиться/развестись	to get divorced; breed	p разведусь, разведёшься, past развёлся, развелась
раздражённо	with irritation, crossly
разлетаться/разлететься	to fly apart; scatter, shatter	p разлечусь, разлетишься
размещаться/разместиться	to be seated, placed, accommodated, take one’s place	p размещусь, разместишься
разновидность (f)	variety, type	f
разрываться/разорваться	to break; explode	p разорвётся, past разорвался, разорвалась
разоряться/разориться	to be ruined, bankrupt
разрешаться (i)	to be permitted; be resolved	i Курить не разрешается Smoking is not permitted
раса	race (ethnic)
раскаиваться/раскаяться (в +pr)	to repent (of sth)
раскидывать/раскинуть (+a)	to stretch out, extend
расправляться/расправиться (с +inst)	to deal with; straighten out	p расправлюсь, расправишься
расцветать/расцвести	to blossom, bloom	p расцвету, расцветёшь, past расцвёл, расцвела
реализм	realism
регулярно	regularly
регулярный	regular
ремонтировать (i/p) (+a)	to repair, redecorate	i/p ремонтирую
ржавый	rusty
робеть/о-	to be timid	i робею, робеешь
розыгрыш	(lottery) draw; practical joke
роковой	fateful
роскошный	luxurious
рослый	tall, strapping
рыться/по- (в +pr)	to dig, rummage (in)	i роюсь, роешься
самоотверженный	self-sacrificing
санитарный	medical, sanitary
седина	grey hair	nom pl седины
секретный	secret (adj)
секция	section
семьсот	seven hundred	g семисот
сессия	session; examinations
склонять/склонить (+a)	to bend, bow	p склоню, склонишь
слияние	confluence; merging
сложно	complicated(ly)
мешать/с- (+a)	to mix	мешать i/смешивать i
смешиваться/смешаться	to mix, mingle; get mixed up
смола	tar, pitch	nom pl смолы
смущённый	embarrassed
собранный	disciplined; precise
совпадение	coincidence
сомнительный	doubtful, dubious
сосредоточиваться/сосредоточиться (на +pr)	to concentrate (on)
спасительный	saving, life saving
спирт	alcohol, spirit	pr sg в спирте or в спирту, nom pl спирты
сплочённый	united
ставень (m)	shutter	(also ставня) g pl ставней and ставен
темнеть/с-	to get dark	p стемнеет
стирать/стереть (+a)	to rub off; grind down	p сотру, сотрёшь, past стёр, стёрла
сталкивать/столкнуть (+a)	to push off; to knock together
стон	groan
стоп	stop!
суетиться/за-	to run around, fuss about	i суечусь, суетишься
суконный	cloth (adj)
счастливец	lucky man
счёты (pl)	abacus	g pl счётов
таракан	cockroach
тахта	divan
телеграфный	telegraph (adj)
терпеливый	patient
тесто	pastry, dough
толчок	push; jolt
топтаться (i)	to stamp	i топчусь, топчешься
торговец	trader
тоскливо	drearily
тоскливый	depressed, depressing
требовательный	demanding
тренировка	training	g pl тренировок
треть (f)	third	g pl третей
трогаться/тронуться	to set off
трусливый	cowardly
тряпьё	rags
тряхнуть (p)	to shake
тсс	shh! keep quiet!
тумба	pedestal; bollard
тучка	small cloud	g pl тучек
угнетать (i) (+a)	to oppress
удочка	fishing rod	g pl удочек
укоризненно	reproachfully
уместно	appropriately
умысел	intention
унижать/унизить (+a)	to humiliate
уничтожаться/уничтожиться	to be destroyed
управляемый	controlled
управляться (i)	to be controlled; (c +inst) deal with	i управляюсь
усиленно	intensively
усиленный	intensive, intensified
ухитряться/ухитриться (+inf)	to manage (to do sth) (coll)
уют	comfort, cosiness
уютно	cosily
уяснять/уяснить (+a)	to understand
фальшивый	false
фарфор	porcelain
фасад	façade
характеризоваться (i) (+inst)	to be characterized (by)	i характеризуюсь
хлебнуть (р)	to drink (coll)	p
хлопотать/по-	to bustle about; make efforts	i хлопочу, хлопочешь
холодок	coolness; cool place (coll)
хорошенько	properly (coll)
хрипеть (i)	to wheeze	i хриплю, хрипишь
христианский	Christian
хромать (i)	to limp	i
хромой	lame
худший	worst
цветущий	blooming; flourishing
целесообразность (f)	expediency	f
человечность (f)	humaneness, humanity	f
чернеть/по-	to turn black	i чернею, чернеешь
чёртов	devil’s (adj)	чёртова дюжина baker’s dozen
чудовище	monster
чужбина	foreign land	no pl; на чужбине in foreign parts
шахтёр	miner
шеренга	rank, file, column
шестнадцатый	sixteenth
штора	(window) blind
шуршать (i)	to rustle	i шуршу, шуршишь
авантюрист	adventurer
авиационный	aviation (adj)
агитировать (i)	to agitate, campaign	i агитирую
акт	act (of play); document
али	or (coll) (= или)	= или
аргумент	argument
астрономия	astronomy
базис	basis
баловаться (i)	to play about, indulge os	i балуюсь
бар	bar
бархатный	velvet (adj)
спиртной	alcoholic (adj)	спиртные напитки alcoholic drinks
башмак	shoe	g sg башмака
бедно	poorly, cheaply
безвестный	unknown
безграмотный	illiterate
безделушка	knick-knack, trinket	g pl безделушек
бездельник	idler
бездонный	bottomless
бережливость (f)	thrift	f
берёт	beret
бесплатно	free (without payment)
беспрепятственный	unimpeded, unhindered
бесстрашно	fearlessly
бешенство	fury; rabies
биолог	biologist
биржа	exchange; stock exchange биржа труда labour exchange
сносить/снести (+a)	to demolish; take down, take off; carry away	i сношу, сносишь; p снесу, снесёшь, past снёс, снесла
бланк	form (document)
близиться/при-	to draw near	i ближусь, близишься
близорукий	short-sighted
блуждать (i)	to wander	i
богато	richly
боеприпасы (pl)	ammunition	g pl боеприпасов
бойня	slaughter-house	g pl боен
боязно  (+d) (+inf)	afraid (coll)	Ей боязно She’s afraid
брешь (f)	breach
булыжник	cobble-stone; cobbles
буркать/буркнуть	to mutter, growl (coll)
валюта	currency; foreign currency	твёрдая валюта hard currency
ватный	quilted; cotton wool (adj)
ввысь	upwards
вдогонку	in pursuit (coll)	пуститься вдогонку за кем-нибудь to rush off after s.o.
венский	Viennese
вериться (i) (+d)	to believe	i Мне не верится, что ... I cannot believe that...
версия	version
вестник	messenger
устаревать/устареть	to become obsolete, go out of date	p устарею, устареешь
взрываться/взорваться	to explode	p взорвусь, взорвёшься
взятие	taking, capture
взятка	bribe	g pl взяток
винить/об- (+a в +pr)	to accuse (s.o. of sth)
вкусно	tasty
тонуть/у-	to drown	p утону, утонешь; тонуть i/утопать i
властно	imperiously
властный	imperious; authoritative
влечь (р) (+a)	to draw; attract	p влеку, влечёшь, влекут, past влёк, влекла
водоросль (f)	seaweed	f
возбуждающий	arousing, stimulating
возбуждённо	excitedly
воздвигать/воздвигнуть (+a)	to raise, erect	p past воздвиг, воздвигла
воздействовать (i/p) (на +a)	to affect, influence, put pressure on	i/p воздействую
возмущать/возмутить (+a)	to anger, outrage	p возмущу, возмутишь
вооружаться/вооружиться	to arm os
восемнадцатый	eighteenth
воскресать/воскреснуть	to come back to life; revive	p past воскрес, воскресла
воспитываться/воспитаться	to be brought up; be fostered
вражда	enmity
враждебно	hostilely
предвыборный	election (adj)	предвыборная кампания election campaign
врозь	separately	жить врозь to live apart
всенощная	night service (church)
всероссийский	all-Russian
выборный	electoral; elected	выборная должность elective office
выбывать/выбыть (из +g)	to leave (formal)	p выбуду, выбудешь
выговаривать/выговорить (+a)	to pronounce, articulate; (coll, i only) tell off, reprimand
выживать/выжить	to survive	p выживу, выживешь
выкидывать/выкинуть (+a)	to throw out
выметать/вымести (+a)	to sweep out	p вымету, выметешь, past вымел
выплата	payment
выполняться (i)	to be fulfilled	i выполняется
выпуклый	prominent, bulging; convex
вышвыривать/вышвырнуть (+a)	to throw out, chuck out (coll)
гавань (f)	harbour	f
герб	coat of arms
геройство	heroism
гимнастика	gymnastics
голубчик	my dear (coll)
гонорар	fee; royalties
гоняться (i) (за +inst)	to chase (after)	i гоняюсь
горячиться/раз-	to get excited
гражданка	citizen (f)	g pl гражданок
греться/по-	to warm os	i греюсь, греешься
гулко	resonantly; with an echoing sound
гулянье	festival, fete, open-air party
девятнадцатый	nineteenth
делец	wheeler-dealer	g sg дельца
дерзость (f)	rudeness; audacity	f
доброта	goodness, kindness	no pl
доисторический	prehistoric
документальный	documentary (adj)
домна	blast furnace	g pl домен
досадно	annoying	Ей было досадно, что он опоздал She was annoyed that he came late
достоверность (f)	authenticity, reliability	f
драть/со- (+a)	to tear; thrash; fleece (coll)	i деру, дерёшь, f past драла; разо- p/со- p
дубовый	oak (adj)
дурить (i)	to be naughty, fool about (coll)	f
дымный	smoky
дымчатый	smoke-coloured
дьякон	deacon
дядька (m)	uncle; man, bloke (coll)	m, g pl дядек
ель (f)	fir; spruce	f
ёмкость (f)	capacity	f
жгучий	burning
желательно	(it is) desirable
жерло	mouth, muzzle	nom pl жерла, g pl жерл
жёрнов	millstone	nom pl жернова
жизнерадостный	cheerful, happy
забвение	oblivion
заботливо	solicitously
забрести (р)	to wander in, drop in; stray	p забреду, забредёшь, past забрёл, забрела
загар	suntan
загибать/загнуть (+a)	to bend
загораживать/загородить (+a)	to fence in; obstruct	p загорожу, загородишь
загрузка	loading
задержка	delay	g pl задержек
зазвенеть (р)	to begin to ring	p зазвенит
заладить (р) (+a)	to keep repeating (sth); (+inf) get into the habit of (coll)	p залажу, заладишь
залетать/залететь (в +a)	to fly in; (за +a) fly behind	p залечу, залетишь
заливаться/залиться	to be flooded; (+inst) start to do sth vigorously	p зальюсь, зальёшься, past залился, залилась; залиться смехом to burst out laughing
маскировать/за- (+a)	to disguise, camouflage	p замаскирую
западня	trap	g pl западней
зараза	infection; (coll) pest
заражать/заразить (+a +inst)	to infect (s.o. with sth)	p заражу, заразишь
резать/за- (+a)	to kill	p зарежу, зарежешь
заслонять/заслонить (+a)	to shield, conceal, screen	i заслоняю
обнадёживать/обнадёжить (+a)	to give hope (to), reassure
затворять/затворить (+a)	to close	p затворю, затворишь
затериваться/затеряться	to go missing, be mislaid; vanish (coll)	p затеряюсь
захлопывать/захлопнуть (+a)	to bang, slam
защищаться/защититься	to defend os; defend one’s thesis (for a higher degree)
зевать/зевнуть	to yawn
земледельческий	agricultural
злодей	villain
зорко	sharp-sightedly, vigilantly
зять (m)	son-in-law; brother-in-law	m; nom pl зятья, g pl зятьёв
идеализм	idealism
издаваться/издаться	to be published	i издаётся
издавна	since long ago
издательский	publishing (adj)
изумлённо	with amazement
буржуазия	bourgeoisie
классовый	class (political) (adj)	классовая борьба class struggle
алмаз	(uncut) diamond
сосуд	vessel
монополия	monopoly
пятилетка	five-year plan	g pl пятилеток
чайка	seagull	g pl чаек
кислота	acid; acidity	nom pl кислоты
консул	consul
австрйец	Austrian	g sg австрийца
австрийский	Austrian
окорок	ham, gammon	nom pl окорока
майор	major
всесоюзный	all-union (relating to all the republics of the USSR)
углерод	carbon
управляющий (+inst)	manager
колониальный	colonial
красноармёец	Red Army soldier	g sg красноармейца
шарф	scarf
волосок	(a) hair
специализированный	specialized
эксперт	expert
араб	Arab
беженец	refugee
вахта	watch (on ship); special work shift
трест	trust; group of companies
хоккеист	hockey player
всадник	horseman
вычислительный	calculating, computing	вычислительная техника computers
гипс	plaster (of Paris)
общаться (i) (с +inst)	associate, socialize (with)	i
заготовка	state order (for goods); stocking up	g pl заготовок
монархия	monarchy
нравственность (f)	morality	f
длительность (f)	duration	f
мишень (f)	target	f
зарплата (заработная плата)	pay, wages, salary
трасса	route, course (of road etc.)	воздушная трасса airway
казачий	Cossack (adj)	f казачья, n казачье
кухарка	cook (f)	g pl кухарок
облигация	bond
вальс	waltz
кормовой	stem (of ship - adj); fodder (adj)
астроном	astronomer
воззрение	opinion, outlook
кодекс	code, codex
эфир	air (broadcasting); ether	выйти в эфир to go on the air
зола	ashes, cinders	no pl
китель (m)	military jacket, high-necked tunic	nom pl кителя
концентрация	concentration
обождать (р) (+a)	to wait (coll)	p обожду, обождёшь
превосходительство	excellency (title)
буржуй	bourgeois (noun) (coll)
идейный	ideological; containing ideas; progressive; high-principled
электронный	electronic
буксир	tugboat; tow-rope
лакей	lackey; servant
пропуск	pass, permit; blank, gap	(nom pl пропуска) pass, permit; (nom pl пропуски) blank, gap
осадок	sediment; deposition; after-taste	осадки precipitation (rain, snow)
растительный	vegetable (adj)	растительное масло vegetable oil
ячейка	cell	g pl ячеек
артиллерист	gunner
сосуществование	coexistence
озимый	winter of crops	озимые winter crops
поручик	lieutenant (tsarist army)
горничная	maid (servant)
терраса	terrace
вселённая	universe
люк	hatch, hatchway, manhole
скептик	sceptic
светящийся	luminous
хрусталь (m)	crystal, cut glass	m; g sg хрусталя
плуг	plough	nom pl плуги
частушка	chastushka, witty rhyme
ширма	screen
союзный	allied; of the USSR
спекулянт	speculator
тренер	trainer, coach
брусок	bar, ingot
гранит	granite
кролик	rabbit
монументальный	monumental
водород	hydrogen
очко	point (in scoring); (pl) glasses, spectacles	nom pl очки, g pl очков; в очках wearing glasses
рудник	mine (for minerals)	g sg рудника
футбол	football
хутор	farm; Ukrainian hamlet	nom pl хутора
потребление	consumption	товары широкого потребления consumer goods
республиканский	republican
кратер	crater
атмосферный	atmospheric
световой	light (adj, as in ‘light year’)	световые полосы strips of light
станица	Cossack village
руда	ore	nom pl руды
бабка	grandmother; old woman (coll)	g pl бабок
канадец	Canadian (man)
кукуруза	maize
лирический	lyrical
нары (pl)	bunk, plank-bed	g pl нар
научно-технический	scientific and technical
серный	sulphuric
фланг	flank
шестёрка	six; group of six	g pl шестёрок
шеф	boss, chief
брус	beam (of wood or metal)	nom pl брусья, g pl брусьев
египетский	Egyptian
излучать/излучить (+a)	to radiate
коммунистический	communist (adj)
контрреволюция	counter-revolution
котлован	foundation pit, trench
линза	lens
обоз	string of carts; military transport
аж	even (coll) (= даже)	= даже
буфетчик	barman
кубометр	cubic metre
курган	barrow, burial mound
металлургический	metallurgical
обсерватория	observatory
отчётный	report (adj), reporting	отчётный доклад report
платёжный	payment (adj)
платёж	payment	g sg платежа
покуда	while (coll) (= пока)	= пока
сочный	juicy, rich
суша	(dry) land (opposite of sea)
агитатор	agitator
альпийский	alpine
батя (m)	dad, father (coll) (= батюшка)	= батюшка
большевистский	Bolshevik (adj)
стабильность (f)	stability	f
гимназист	grammar-school pupil
изумруд	emerald
проектирование	planning
урожайность (f)	crop productivity, yield	f
физкультура	physical training
устный	oral	устный экзамен oral examination
выемка	taking out; collection (of letters)
гармошка	accordion (coll)	g pl гармошек
горком	town committee	= городской комитет
заряженный	loaded (of weapon)
караван	caravan; convoy
крона	crown (of tree); crown (currency)
механика	mechanics
накидка	cloak, mantle, cape	g pl накидок
отставлять/отставить (+a)	to set aside	p отставлю, отставишь
павильон	pavilion
патруль (m)	patrol	m
портовый	port (adj)
проситься/по- (+inf or в/на +a)	to ask for	i прошусь, просишься
скульптор	sculptor
упираться/упереться (в +a)	to lean (against); come up against
уполномоченный	plenipotentiary; person authorized
шайба	washer; (hockey) puck
штатский	civilian (adj) (not military)
штык	bayonet	g sg штыка
альбом	album
Богородица	the Virgin
валовой	gross (adj)	валовой доход gross income; валовой национальный продукт gross national product
гол	goal (sport)	nom pl голы, g pl голов
грузчик	docker; freight handler
двусторонний	double-sided, two-way; bilateral
девальвация	devaluation
десятина	desiatina (about a hectare)
козырёк	peak (of cap)	g sg козырька; взять под козырёк to salute
субъективный	subjective
вожжа	rein	nom pl вожжи, g pl вожжей
гамма	scale; gamut, range
карниз	cornice; ledge
древесина	timber
опрос	survey; questioning	опрос общественного мнения opinion poll
католический	Catholic (adj)
комета	comet
литератор	literary man, man of letters
перевозка	transportation	g pl перевозок
подвижный	mobile, agile
проектный	planning (adj); projected
раковина	(sea)shell; sink, wash-basin
семечко	(small) seed	nom pl семечки, g pl семечек
сера	sulphur
сметана	sour cream
суждено (+d +inf)	it is fated	Нам суждено было встретиться We were fated to meet
ввод	bringing in
внешнеполитический	foreign-policy (adj)
вредитель (m)	pest	m
дотация	subsidy
жилетка	waistcoat	g pl жилеток
заболевание	illness
закалка	physical training, fitness
залежь (f)	(mineral) deposit	f
зерновой	grain (adj)
изготовляться/изготовиться	to be manufactured; get ready	i изготовляется
инспекция	inspection
коллективизация	collectivization
конструкторский	design (adj)
кооперация	cooperation
лесничий	forest warden, ranger
лишение	deprivation	лишение свободы imprisonment
производитель (m)	producer	m
феномен	phenomenon
радист	radio operator
упрочение	strengthening
уран	uranium
хам	boor (coll)
хрустальный	crystal (adj)
алкоголик	alcoholic (noun)
чреватый (+inst)	fraught (with)	Это чревато опасностью This is fraught with danger
география	geography
душевно	mentally; cordially
известь (f)	lime (chemical)	f
конюшня	stable	g pl конюшен
крупа	groats (grain)
лягушка	frog	g pl лягушек
металлургия	metallurgy
мыс	cape, promontory	pr sg на мысе or на мысу
обследовать (i/p) (+a)	to investigate	i/p обследую
отрез	cut
перемирие	truce
плот	raft	g sg плота
предусматриваться (i)	to be envisaged, be stipulated	i
принуждение	compulsion
прирост	increase
разгадывать/разгадать (+a)	to guess, work out
растворять/растворить (+a)	to open; dissolve	p -творю, -творишь
реактивный	jet-propelled
рысь (f)	trot; lynx	f; на рысях at a trot
рюкзак	rucksack	g sg рюкзака
связист	signaller; communications engineer
синтетический	synthetic
сострадание	compassion
старт	start (sport)
сушить/вы- (+a)	to dry (sth)	i сушу, сушишь
декада	ten-day period
завоеватель (m)	conqueror	m
катушка	reel, spool	g pl катушек
китаец	Chinaman	g sg китайца
комендатура	commandant’s office
котлета	cutlet; meatball, hamburger
математический	mathematical
микрофон	microphone
обострение	intensification, sharpening
пират	pirate
плавки (pl)	swimming trunks	g pl плавок
поваренный	culinary	поваренная книга cookery book
престарелый	aged, of advanced years	дом для престарелых old people’s home
пурга	blizzard	no pl
репортёр	reporter
свинство	swinish trick (coll)
секретарша	(female) secretary (coll)
таёжный	taiga (adj)
убеждённость (f)	conviction	f
шотландский	Scottish
шпага	sword
штабной	staff, headquarters (adj)
щепа	splinter, chip	nom pl щепы, g pl щеп, d pl щепам
эволюция	evolution
экватор	equator
ягнёнок	lamb	nom pl ягнята, g pl ягнят
австралийский	Australian (adj)
антисемитизм	antisemitism
боб	bean	g sg боба
булавка	pin	g pl булавок
ватага	band, gang
воззвание	appeal
всемерный	utmost, every kind of	всемерная помощь all possible assistance
дебют	debut
естествознание	natural science
милосердие	mercy, charity
карусель (f)	merry-go-round, carousel	f
кондиционер	air conditioner
хозрасчёт	self-financing
чутьё	scent; instinct, intuition	женское чутьё female intuition
накалённый	white-hot; tense
новатор	innovator
оптимальный	optimal
остов	framework
отсек	compartment
прищуриваться/прищуриться	to screw up one’s eyes, half close one’s eyes
пробег	run, race
прослезиться (р)	to shed tears	p прослежусь, прослезишься
скула	cheekbone	nom pl скулы
ракетный	rocket (adj)
резьба	carving
родовой	ancestral; generic; birth (adj)
социал-демократический	social-democratic
туалет	toilet
футболист	footballer
чемоданчик	small suitcase
шовинизм	chauvinism
шоры (pl)	blinkers	g pl шор
аванс	advance (payment)
атеистический	atheistic
бабушкин	grandmother’s (possessive adj)	в бабушкином доме in grandmother’s house
гипсовый	plaster
ересь (f)	heresy	f
застенок	torture-chamber
кефир	kefir, yoghurt-type drink
извещать/известить (+a)	to inform, notify (bookish)	p извещу, известишь
калач	kalach (small white loaf)	g sg калача; тёртый калач old hand
кличка	nickname; name (of pet animal)	g pl кличек
колокольчик	small bell; bluebell
композиция	composition
контур	contour; outline; electrical circuit
координация	coordination
кочка	hummock	g pl кочек
кубик	child’s building brick
кура	hen (coll) (=курица)	=курица
кустарник	bushes, shrubs
ледниковый	glacial
лепить/вы- (+a)	to model, mould	i леплю, лепишь; вы-, с- р
лирика	lyric poetry
медлить (i)	to be slow, tarry	i
миленький	sweet, nice, dear
мозаика	mosaic
нагреваться/нагреться	to warm os, warm up
обновление	renovation
познавать/познать (+a)	to get to know, experience	i познаю, познаёшь
приостанавливаться/приостановиться	to stop (for a while), pause	p приостановлюсь, приостановишься
расписание	timetable
сажа	soot
светило	luminary
сечение	cutting; section
слива	plum
сношение	intercourse	сношения dealings, relations
туша	carcass
упряжка	team (of horses, dogs); harness	g pl упряжек
утопический	utopian
ходовой	(coll) popular; operational, working	ходовые мнения popular opinions
чувствительность (f)	sensitivity	f
чудный	wonderful
фара	headlamp
шлюз	lock, sluice
шов	seam
шрам	scar
эмигрант	emigrant, emigre
азот	nitrogen
аристократ	aristocrat
бес	demon
беседка	summer-house	g pl беседок
благоустройство	equipping with amenities
болотный	marsh (adj)
брошка	brooch	g pl брошек
варьировать (i) (+a)	to vary, modify	i варьирую
ветвиться/раз-	to branch
вишь	look!
водопровод	water-pipe
возбуждаться/возбудиться	to become aroused
восковой	wax (adj)
восторгаться (i) (+inst)	to be delighted (with)	i
кинотеатр	cinema
доступ (к +d)	access (to)
объект	object; construction site, building
губернатор	governor
дворянство	gentry
дивиться/по- (+d)	to wonder, marvel (at) (coll)	i дивлюсь, дивишься
диктатор	dictator
жёлоб	gutter, chute	nom pl желоба
военно-морской	naval
жилка	vein	романтическая жилка romantic streak
измельчённый	crumbled, chopped up
испарение	evaporation
катер	cutter, launch (boat)	nom pl катера
текстильный	textile (adj)
тюк	bale	g sg тюка
отвал	slag-heap, dump	до отвала to satiety
истечение	outflow; expiry, termination	по истечении +g on the expiry of, after
керосиновый	kerosene (adj)
конус	cone
крепостничество	serfdom
ледовый	ice (adj)
лепёшка	flat cake; scone; lozenge, pastille	g pl лепёшек
лесник	forester, forest ranger	g sg лесника
максимум	maximum
машинистка	typist	g pl машинисток
общенародный	national, of the whole people
оригинал	original; eccentric (noun)
ориентация	orientation
осыпать (i/p) (+a +inst)	to shower (s.o./sth with sth)	осыпа́ть/осы́пать; p осы́плю, осы́плешь
пёрышко	(little) feather (coll)	nom pl пёрышки, g pl пёрышек
пеший	pedestrian, foot (adj)
питерский	St Petersburg (adj) (coll)
победоносный	victorious
карать/по- (+a)	to punish
полковой	regimental
приписка	(written) addition	g pl приписок
промеж (+g or +inst)	between (coll)
резец	cutting tool; incisor (tooth)
репродукция	reproduction
рисоваться (i)	to show off, pose; seem	i рисуюсь
рукоятка	handle	g pl рукояток
серп	sickle	g sg серпа
сирень (f)	lilac	f
собачонка	little dog (coll)	g pl собачонок
соприкосновение	contact
сплав	alloy
срез	cut; cut edge
сток	flow; drain
струйка	thin stream, trickle	g pl струек
сыр	cheese	pr sg в сыре/в сыру, nom pl сыры
термометр	thermometer
транспортировка	transportation
трюм	hold (of ship)
угодье	usable land	g pl угодий; полевые угодья arable land; охотничьи угодья hunting grounds
уцелевший	surviving
участница	participant (f)
имение	estate
инстинкт	instinct
интенсивный	intensive
испанский	Spanish (adj)
извозчик	carrier, cabman
исследовательский	research (adj)
кавказский	Caucasian, of the Caucasus
казарма	barracks
капкан	trap
карьерист	careerist
кастрюля	saucepan	g pl кастрюль
кашель (m)	cough	m
кинжал	dagger
кишка	gut, intestine	g pl кишок
клинок	blade
клоун	clown
клубок	ball (of wool etc.)
кобель (m)	male dog	m; g sg кобеля
кое-какой	some, certain	Он сообщил кое-какие новости He gave us certain items of news
коммерческий	commercial	коммерческий магазин privately-owned shop
коллекционер	collector
колодец	well
колотить/по- (+a)	to batter	i колочу, колотишь
колючка	prickle	g pl колючек
комплект	set, complete set
конвой	escort
коньки (m pl)	skates	m pl; g pl коньков
коньяк	cognac, brandy	g sg коньяка
координировать (i/p) (+a)	to coordinate	(i/p) координирую
копошиться (i)	to swarm	i
копчёный	smoked
копьё	spear	nom pl копья, g pl копий
королёвский	royal
коммунальный	communal	коммунальная квартира communal flat (shared by several families)
космонавт	cosmonaut
краб	crab
красться (i)	to creep	i крадусь, крадёшься, past крался, кралась
кроткий	gentle, meek
кругозор	horizon, outlook
кружить (i) (+a)	to spin; circle	i кружу, кружишь
крымский	Crimean
кудрявый	curly
курсы (m pl)	course, courses (of study)	m pl; g pl курсов
лавина	avalanche
лампада	icon-lamp
ландшафт	landscape
легкомыслие	thoughtlessness
летопись (f)	chronicle	f
ловля	catching	g pl ловeль; рыбная ловля fishing
ложный	false
лупа	magnifying glass
люлька	cradle	g pl люлек
магистраль (f)	main line; main road	f
магнит	magnet
мамин	mother’s (possessive adj)	f мамина, n мамино
мартовский	March (adj)
маскировка	disguise, camouflage
мах	swing, stroke	одним махом at one stroke
маятник	pendulum
мгновенный	instantaneous; momentary
медик	doctor; medical specialist
медлительный	slow
месть (f)	revenge	f
метать/метнуть (+a)	to throw, cast	i мечу, мечешь
метко	accurately
механизировать (i/p) (+a)	to mechanize	i/p механизирую
мираж	mirage
миф	myth
многовековой	centuries-old
мобилизация	mobilization
морщина	wrinkle
мох	moss	pr sg во мху
муравей	ant	g sg муравья, g pl муравьёв
муть (f)	sediment	f
мысленный	mental
мычать (i)	to moo; bellow	i мычу, мычишь
набат	alarm bell
навеки	for ever
наглый	impudent
надстройка	additional storey; superstructure	g pl надстроек
наёмник	mercenary
наличный	available; cash (adj)	наличные деньги cash; наличный расчёт cash payment
напрямик	directly; bluntly (coll)
насаживать/насадить (+a на +a)	to fix (sth onto sth)	p насажу, насадишь
населённый	inhabited	населённый пункт locality, place
насильно	by force
насмерть	to (the) death	испугать насмерть to frighten to death
настораживаться/насторожиться	to prick up one’s ears, be on one’s guard
насыщать/насытить (+a +inst)	to satiate; fill (sth with sth), saturate
насыщенный	saturated; rich (in content)
нате	here you are, take it (coll)
натягивать/натянуть (+a)	to pull tight; pull on	p натяну, натянешь
неблагоприятный	unfavourable
невесёлый	joyless
невесть	no-one knows (coll)	невесть почему God knows why
невзрачный	unattractive
неграмотность (f)	illiteracy	f
незаменимый	irreplaceable
неминуемо	inevitably
необозримый	immense
необычно	unusually
неосторожный	careless
неотъемлемый	inalienable, integral
непоправимый	irreparable
непременный	indispensable	непременное условие sine qua non
неприлично	indecently
неравномерный	irregular
несложный	uncomplicated
несомненный	undoubted
нетронутый	untouched
неудобство	discomfort, inconvenience
неустойчивый	unstable
неприемлемый	unacceptable
нотка	note (sound)	g pl ноток; нотка недоверия note of distrust
нудный	tedious
обиженный	offended
обитать (i)	to live, reside
обкладывать/обложить (+a)	to put round	p обложу, обложишь
облагать/обложить (+a)	to assess (for tax)	p обложу, обложишь
обниматься/обняться	to embrace one another	p обнимусь, обнимешься, pl past обнялись
обогащаться/обогатиться	to become rich	p обогащусь, обогатишься
обогащать/обогатить (+a)	to enrich
обои (pl)	wallpaper	g pl обоев
обороняться/оборониться (от +g)	to defend os (from)	i обороняюсь
обречённый	doomed
обронить (р) (+a)	to drop (and lose); let fall	p оброню, обронишь; no i; обронить замечание to let fall a remark, comment
обстоятельный	detailed, thorough
обстрел	bombardment
обучать/обучить (+a +d)	to teach (s.o. sth)
обыденный	ordinary
окидывать/окинуть (взглядом)	to glance over
оккупационный	occupation (adj)
оковы (pl)	fetters	g pl оков
опережать/опередить (+a)	to outstrip; forestall	p опережу, опередишь
оправляться/оправиться	to recover
организованность (f)	good organization	f
организовывать/организовать (+a)	to organize
орудийный	gun, cannon (adj)
освобождённый	liberated, free
осенью	in autumn
оскорбительный	insulting
слабеть/о-	to become weak	p ослабею, ослабеешь; слабеть/ослабевать i
ослепительный	dazzling
оснащать/оснастить (+a +inst)	to equip (sth with sth)	p оснащу, оснастишь
осознавать/осознать (+a)	to realize
остальное	the rest, remainder
стричь/о- (+a)	to cut, clip	p остригу, острижёшь, остригут, past остриг, остригла; стричь i/ остригать i
островок	islet
отбой	beating off, repulsion; retreat
отбывать/отбыть (+a)	to serve (a period of time); (bookish) depart	p отбуду, отбудешь, f past отбыла
отвага	courage
отваливать/отвалить (+a)	to push away (sth heavy); cast off (boat)	p отвалю, отвалишь
отвесный	steep
отклик	response
отрывок	excerpt
ошибочный	mistaken
панихида	requiem
паром	ferry
пассивный	passive
певец	singer
пепельница	ashtray
перебрасывать/перебросить (+a через +a)	to throw over	p переброшу, перебросишь
передумывать/передумать	to change one’s mind
перекрывать/перекрыть (+a)	to cover again; block off	p перекрою, перекроешь
перелёт	flying over; migration (birds)
переноситься/перенестись	to be carried (over)	i переношусь, переносишься
переодеваться/переодеться	to change one’s clothes; disguise os
переплетаться/переплестись	to be interwoven
переработка	reworking
переступать/переступить (+a or через +a)	to step over	p переступлю, переступишь
персидский	Persian
персонал	personnel, staff
пилить (i) (+a)	to saw; (coll) nag	i пилю, пилишь
пластический	plastic (adj); artistically expressive
пленительный	captivating
плотность (f)	solidity; density	f
побаиваться (i) (+g)	to be rather afraid of
грузиться/по-	to get on board, embark
погрузка	loading
подавлять (i) (+a)	to suppress	i подавляю; подавить
подпирать/подпереть (+a)	to prop up	p подопру, подопрёшь, past подпёр, подпёрла
подставлять/подставить (+a под +a)	to put under	i подставляю; p подставлю, подставишь
подталкивать/подтолкнуть (+a)	to push slightly; (coll) urge on
подтянутый	self-controlled; well turned out, smart
жертвовать/по- (+a)	to donate; (+inst) sacrifice	p пожертвую
покрывало	cover; bedspread
половица	floorboard
получка	pay, wages (coll)
полый	hollow
махать/по- (+inst)	to wave (for a while)	p помашу, помашешь
медлить/по-	to delay, hesitate
мерещиться/по-	to seem (coll), imagine
помёт	dung, droppings
пометка	mark, note	g pl пометок
поприще	field (of activity)
попутно	on the way; in passing
попутный	accompanying; passing	попутный ветер favourable wind
радовать/по- (+a)	to gladden, please	p порадую
радоваться/по- (+d)	to be glad (at)	p порадуюсь
поражённый	defeated; astounded
порывисто	jerkily; suddenly
постигать/постичь (+a)	to comprehend; befall	p постигну, постигнешь, past постиг, постигла
потемневший	darkened
толковать/по- (о +pr с +inst)	to have a talk about sth with s.o. (coll)	p потолкую
потомственный	hereditary
потрясённый	staggered, stunned
похороны (pl)	funeral	g pl похорон, d pl похоронам
по-человечески	like a human being
почём	how much?; how? (coll)	Почём виноград? How much are the grapes?
почтальон	postman
почтение	respect
предок	ancestor
предсказание	prediction
премьера	premiere, first night
препятствовать (i) (+d)	to hinder	i препятствую
приглядываться/приглядеться (к +d)	to look closely at (coll)	p пригляжусь, приглядишься
пригород	suburb
приёмный	reception (adj); adopted
приземистый	stocky, squat
прикрываться/прикрыться (+inst)	to use as a cover, hide behind
применительно (к +d)	with reference to
примыкать (i) (к +d)	to join, side with; (i only) примкнуть p adjoin, be adjacent to
приподнятый	elated
прихватывать/прихватить (+a)	to grip; fasten; take (coll)	p прихвачу, прихватишь
причинять/причинить (+a)	to cause	i причиняю
будить/про- (+a)	to awaken	p пробужу, пробудишь; будить i/пробуждать i
пробыть (р)	to spend (a certain time)	p пробуду, пробудешь, past пробыл, пробыла, пробыло
проголодаться (р)	to get hungry
продвигаться/продвинуться	to advance, move forward
продовольственный	food (adj)	продовольственный магазин food shop
продуктивность (f)	productivity	f
проезд	thoroughfare; journey
прозвище	nickname
преступность (f)	crime, criminality	f
прокат	hire
проклятие	curse
пролезать/пролезть (в +a)	to climb through, go through	p пролезу, пролезешь, past пролез, пролезла
променивать/променять (+a на +a)	to exchange (sth for sth)	p променяю
промысел	trade, business
пронзительный	penetrating
полноценный	genuine, complete, of good quality	полноценная пища proper food
просвет	shaft of light; aperture
простительно	pardonably
противопоставлять/противопоставить (+a +d)	to contrast (sth with sth), set sth against sth	i противопоставляю; p противопоставлю, противопоставишь
протяжно	slowly, lingeringly; with a drawl
публикация	publication
пуск	starting up, launch
пятёрка	the number five; excellent (exam mark)	g pl пятёрок
развитой	developed, mature
разговориться (p)	to become talkative
разевать/разинуть (+a)	to gape (coll)	p разинуть рот to gape
разогревать/разогреть (+a)	to heat up	p разогрею, разогреешь
разрастаться/разрастись	to grow, expand, spread	p разрастётся, past разросся, разрослась
разрезать (i/p) (+a)	to cut up	разреза́ть/разре́зать; p разре́жу, разре́жешь
разузнавать/разузнать (+a)	to find out
разъезд	departure, dispersal	разъезды travels
разъяснение	explanation
распрощаться (p) (с +inst)	to say goodbye (to s.o.) (coll)	also распроститься р
расстроенный	upset
расхаживать (i)	to pace up and down
рвануть (р) (+a)	to tug; (coll) jerk into motion
реконструировать (i/p) (+a)	to reconstruct	(i/p) реконструирую
рельеф	relief (geog, art)
репрессия	repression	сталинские репрессии Stalin’s purges
родительский	parents’
родник	spring (water source)	g sg родника
романтика	romance, romanticism
реагировать/от- (на +a)	to react (to)	реагирую; про-/от- р
рубиновый	ruby (adj)
рубрика	heading, rubric
рукопожатие	handshake
рыболовный	fishing (adj)
садовод	gardener
самка	female (animal)	g pl самок
самогон	home-made vodka
самоубийство	suicide
сахарный	sugary
свёкла	beet
свергать/свергнуть (+a)	to overthrow	p свергну, свергнешь, past сверг, свергла
светать (i)	to get light, dawn	i В июне светает рано It gets light early in June
светский	(high) society (adj); secular
свойственно (+d)	(it is) characteristic (of)
сгорание	combustion
сгоряча	in the heat of the moment
сдвинутый	shifted
сдерживаться/сдержаться	to control os	p сдержусь, сдержишься
свитер	sweater	nom pl свитера
сектор	sector
серьёзность (f)	seriousness	f
сибиряк	Siberian	g sg сибиряка
сито	sieve
сквозной	through (adj)	сквозной ветер draught; сквозной поезд through train
склянка	phial, bottle	g pl склянок
сковородка	frying-pan	g pl сковородок; dim of сковорода frying pan
скопляться/скопиться	to accumulate	p скопится
скороговорка	tongue-twister; rapid speech	g pl скороговорок; говорить скороговоркой to gabble
славиться (i) (+inst)	to be famous for	i славлюсь, славишься
славянский	Slavonic
сложение	build, composition; addition (arithmetic)
смывать/смыть (+a)	to wash off	p смою, смоешь
сниматься/сняться	to be taken off; move off; have one’s picture taken; come off; act in a film; be photographed	p снимусь, снимешься, past снялся, снялась
собачка	small dog; trigger; catch	g pl собачек
соблюдаться (i)	to be observed, be adhered to
соприкасаться (i) (с +inst)	to adjoin, be in contact with
сорняк	weed	g sg сорняка
социал-демократ	social democrat
сочетать (i/p) (+a с +inst)	to combine (sth with sth)	i/p
спад	fall, slump
спекуляция	speculation
спешно	urgently, hurriedly
спешный	urgent
старательно	diligently, painstakingly
стая	flock, pack
стержень (m)	pivot, rod	m
стирка	washing (of clothes)
стратегия	strategy
стропило	rafter, roof beam
суеверный	superstitious
сухопутный	ground (adj) (troops)
сущий	real, absolute (coll)	сущая правда the honest truth
сюртук	frock-coat	g sg сюртука
табличка	door-plate, nameplate, plaque	g pl табличек
тактический	tactical
танковый	tank (adj)	танковый полк tank regiment
тара	packaging
татарский	Tatar (adj)
творчески	creatively
телёнок	calf	nom pl телята, g pl телят
толком	clearly; properly (coll)	Он толком ничего не сделает Не won’t do anything properly
теоретически	theoretically
терзать (i) (+a)	to torment; pull about
теснота	tightness; cramped conditions
техникум	technical college
тигр	tiger
томительный	tiresome
тонко	thinly; delicately; subtly
торт	cake
трамплин	spring-board; ski-jump
тревожиться/вс-	to worry
треугольник	triangle
тринадцать	thirteen
тщательный	thorough
убираться/убраться	to tidy up; clear off, make os scarce (coll)
уговор	agreement; persuasion
указание	indication; instruction
удаление	removal
удирать/удрать	to run away, do a bunk (coll)	p удеру, удерёшь, f past удрала
указываться/указаться	to be indicated
уклончиво	evasively
укор	reproach
укутывать/укутать (+a)	to wrap (s.o.) up
улучшаться/улучшиться	to improve
умелый	skilful
умножать/умножить (+a)	to multiply
уныние	dejection, gloom
упорство	persistence; obstinacy
управляться/управиться (с +inst)	to cope with (coll)	p управлюсь, управишься
урегулирование	regulation; adjustment
усатый	with a moustache; whiskered
условливаться/условиться (c +inst о +pr/inf)	to make an arrangement (with s.o. about sth/to do sth)	p условлюсь; условишься
условно	conditionally, provisionally
услыхать (р) (+a)	to hear (= услышать р)	p услышу, услышишь
усматривать/усмотреть (+a в +pr)	to see (sth in sth), interpret as
ухватывать/ухватить (+a)	to seize	p ухвачу, ухватишь
факел	torch
фактический	actual	фактическое признание de facto recognition
фермер	farmer
физически	physically
флейта	flute
формировать/с- (+a)	to form	i формирую
хижина	shack, cabin
хихикать/хихикнуть	to giggle
хладнокровный	cool, calm, composed
храбрость (f)	bravery	f
хрипло	hoarsely
хриплый	hoarse
царица	tsarina, empress
частенько	quite often (coll)
частично	partially
червь (m)	worm	m; g sg червя, nom pl черви, g pl червей
черноморский	Black Sea (adj)
чудно	wonderfully
чуткий	sensitive
шалаш	cabin (made of branches)	g sg шалаша
шампанское	champagne
шахматный	chess (adj)
шкафчик	small cupboard
шоссейный	highway (adj)
щёлка	chink	g pl щёлок
щит	shield	g sg щита
экономно	economically, thriftily
энергетика	power engineering
эстрада	stage
этика	ethics
янтарный	amber (adj)
янтарь (m)	amber	m; g sg янтаря
ад	hell	pr sg в аду
аккорд	chord
активизация	activization
алтарь (m)	altar	m; g sg алтаря
антенна	antenna; aerial
апельсин	orange
апостол	apostle
армейский	army (adj)
ассигнование	allocation	ассигнования на народное образование funding for education
баран	ram (sheep)
баян	bayan, Russian accordion
безграмотность (f)	illiteracy	f
бездна	abyss; (coll) (+g) great quantity	бездна дел a huge number of things to do
бездушный	heartless
беззаветно	selflessly
безмолвно	silently
безнаказанно	with impunity
безошибочно	correctly, accurately
безуспешно	unsuccessfully
белила (pl)	whitewash	pl; g pl белил
беречься (i)	to be careful	i берегусь, бережёшься, берегутся, past берёгся, береглась
бесследно	without trace	исчезнуть бесследно to vanish without trace
бесстыдно	shamelessly
бизнесмен	businessman
благополучный	successful
блаженство	bliss
допустимый	permissible
блиндаж	dug out	g sg блиндажа
блюдечко	small dish, saucer
богач	rich man	g sg богача
бодро	cheerfully, heartily
бойко	boldly, briskly
бомбить/раз- (+a)	to bomb	i бомблю, бомбишь
браслет	bracelet
брожение	ferment
броня (бронь)	reservation, booking	бро́ня
броня	armour-plating	броня́
бросок	throw; bound
будка	booth	g pl будок
буквальный	literal
бутерброд	(open) sandwich
бухгалтер	bookkeeper
бюрократический	bureaucratic
бюрократия	bureaucracy
вдребезги	to pieces
венец	crown, wreath; halo
веселить/раз- (+a)	to cheer up; amuse
весомый	weighty
вещица	little thing, knick-knack
взаимовыгодный	mutually advantageous
взыскание	penalty, punishment
виноградник	vineyard
винт	screw; propeller	g sg винта
долгосрочный	long-term
вице-президент	vice-president
влево	to the left
внушительно	impressively
вовлекать/вовлечь (+a в +a)	to involve (s.o. in sth)
водопад	waterfall
воедино	together	собрать воедино to bring together
военщина	militarism; militarists
вожак	guide, leader	вожака
возвышенный	elevated; lofty	возвышенный стиль elevated style
вол	ox	g sg вола
вопиющий	flagrant, scandalous	вопиющее безобразие absolute disgrace
воровство	stealing
ворона	crow
ворчливо	grumpily, querulously
восемьсот	eight hundred	g восьмисот
всеобъемлющий	comprehensive, all-embracing
вульгарный	vulgar
входной	entrance (adj)	входная плата entrance fee
выгружать/выгрузить (+a)	to unload	p выгружу, выгрузишь
выдаваться/выдаться	to stick out	i выдаюсь, выдаёшься
выдача	issue, giving out
выдвигаться/выдвинуться	to move out; go up in the world
выжидательно	expectantly
выжидательный	waiting, expectant
выжидать/выждать (+a)	to wait (for)
выздоравливать/выздороветь	to recover, get better	p выздоровею, выздоровеешь
выныривать/вынырнуть	to come to the surface
высовывать/высунуть (+a)	to thrust out
высококачественный	high-quality
геройский	heroic
глинистый	clay (adj)
глоток	gulp, mouthful
гнуть/со- (+a)	to bend	i гну, гнёшь
годный	suitable	ни к чему не годный worthless
голландский	Dutch
гололёд	covering of ice; icy weather
горлышко	neck (of bottle); small throat	g pl горлышек
горчица	mustard
грозиться/по- (+inf)	to threaten (coll)	i грожусь, грозишься
грохотать/за-	to thunder, rumble	i грохочу, грохочешь
гряда	ridge; bed (garden)	nom pl гряды, d pl грядам
грядка	bed (for plants), flowerbed	g pl грядок
губительный	destructive
девственный	virgin (adj)
дежурить (i)	to be on duty
детвора	kids (coll)	no pl
деяние	act, action (bookish)
добродушно	kindly, good-naturedly
добываться/добыться	to be obtained
доверительно	confidentially
довериться (p) (+d)	to trust (in), confide in	p доверяться
доверчивый	trusting
дождик	shower (rain)
докладчик	speaker (at conference)
доктрина	doctrine
донесение	report, dispatch
достоверный	reliable
дохнуть/по-	to die (of animals)	i дохнет, past дох, дохла
дышать/дохнуть	to breathe	p дохну, дохнёшь
дощечка	nameplate; small board	g pl дощечек
доярка	milkmaid	g pl доярок
дрожь (f)	trembling	f
дубина	cudgel, club; blockhead, idiot
дуга	arc, curve	nom pl дуги
дудка	pipe, fife	g pl дудок; (coll) Дудки! Not likely! No way!
дымовой	smoke (adj)
дырявый	full of holes
дьявольски	devilishly
единодушно	unanimously
жалобный	plaintive; complaints (adj)	жалобная книга complaints book
живучий	hardy, enduring
живьём	alive (coll)
житие	life, biography
бормотать/за- (+a)	to mutter	p забормочу, забормочешь
забрасывать/забросить (+a)	to throw, cast; abandon; neglect	p заброшу, забросишь
завершаться/завершиться	to be finishing, end
завещать (i/p) (+a +d)	to bequeath (sth to s.o.)	i/p
загадочно	mysteriously
глохнуть/за-	to die away; stall (engine); go to seed	p past заглох, заглохла
загонять (р) (+a)	to tire out	p загоняю
загробный	beyond the grave	загробный мир the next world
зад	back, rear; rump, backside	pr sg на заду, nom pl зады
задолго	long before	задолго до конца long before the end
зажигаться/зажечься	to light up, be lit
жмуриться/за-	to screw up one’s eyes; half-close one’s eyes
заинтересованный (в +pr)	interested (in)
кипеть/за-	to boil	p закипит
закладка	laying; bookmark	g pl закладок
заматывать/замотать (+a)	to wind, twist; tire out
ночевать/за-	to spend the night	p заночую
заокеанский	transoceanic
запасаться/запастись	to stock up (with)	p запасусь, запасёшься, past запасся, запаслась
заподазривать/заподозрить (+a в +pr)	to suspect (s.o. of sth)
запаздывать/запоздать (с +inst)	to be late (with)
запрет	ban
запрягать/запрячь (+a)	to harness
запутываться/запутаться	to get confused
заросший	overgrown
засаживаться/засесть	to sit down, lodge os (coll)	p засяду, засядешь, past засел, засела
застенчивый	shy
затаивать/затаить (+a)	to conceal	p затаить дыхание to hold one’s breath
затруднять/затруднить (+a)	to make difficult, complicate; trouble	i затрудняю
затяжка	delay; inhalation (smoking)	g pl затяжек
заулыбаться (р)	to start smiling
заурядный	ordinary, mediocre
зеленеть/по-	to turn green, look green	i зеленеет
констатировать (i/p)	to ascertain; certify	i/p констатирую
знаменитость (f)	celebrity	f
зной	hot weather
зрелый	mature, ripe
зреть/со-	to ripen, mature	i зрею, зреешь
импортный	imported
идиллия	idyll
идол	idol
избивать/избить (+a)	to beat up	p изобью, изобьёшь
излишне	excessively
иллюстрация	illustration
именины (pl)	name-day	g pl именин
инерция	inertia
иностранец	foreigner
иронический	ironical
искание	search
испытанный	tested, tried
истекать/истечь	to flow out; expire (time)
истерия	hysteria	военная истерия war hysteria
исток	source
истребление	extermination
исчерпывать/исчерпать (+a)	to exhaust
кабала	slavery; servitude
каморка	small room (coll)	g pl каморок
каприз	caprice
каторжный	hard-labour (adj)
каучук	rubber
каяться/рас- (в +pr)	to repent	i каюсь, каешься
кверху	upwards
кипа	pile, stack	кипа бумаг pile of papers
кит	whale	g sg кита
кладка	laying	кирпичная кладка bricklaying
клетчатый	checked
климатический	climatic
клюква	cranberry, cranberries	no pl
кляча	nag (horse)
кобыла	mare
колесико	little wheel; cog	nom pl колесики, g pl колесиков
колечко	little ring, ringlet	nom pl колечки, g pl колечек
колыбель (f)	cradle	f
консерватория	conservatoire, music academy
консервный	canned food (adj)
контрреволюционер	counter-revolutionary
кормиться (i) (+inst)	(p по-) to be fed, eat; (p про-) live on	i кормлюсь, кормишься
королева	queen
корона	crown
корыстный	self-interested, mercenary, selfish
костяной	bone (adj), made of bone
кратковременный	brief, short-term
крашеный	painted; dyed
кривляться (i)	to behave affectedly (coll)	i кривляюсь
криво	crookedly, squint
кружево	lace	also кружева pl
крупно	on a large scale
кудри (pl)	curls	g pl кудрей
купанье or купание	bathing
купе	compartment (train)	n indecl
ладить/по- (с +inst)	to get on with (s.o.)	i лажу, ладишь
лебедь (m/f)	swan	m/f; g pl лебедей
легальный	legal
ледник	glacier	g sg ледника
лесенка	small staircase; short ladder (coll)	g pl лесенок
лесоруб	lumberjack
лизать/лизнуть (+a)	to lick	i лижу, лижешь
лимон	lemon
лиса	fox	nom pl лисы
листать (i) (+a)	to leaf through (coll)	i
лифт	lift, elevator
льгота	privilege, advantage	налоговые льготы tax relief
льдина	block of ice
любовный	love (adj)
медвежий	bear’s	f медвежья, п медвежье; медвежья услуга dubious benefit
меж (+inst or +g)	between	= между
мёрзнуть/за-	to freeze	i мёрзну, мёрзнешь; past мёрз, мёрзла
мерить/из- (+a)	to measure; try on (clothing)	из- р; по-/при- р
мерцать (i)	to twinkle, flicker	i
мех	fur	pr sg в меху; nom pl меха
механизированный	mechanized
механически	mechanically
мещанский	bourgeois, petty bourgeois; narrow-minded
мещанство	petty bourgeoisie, lower middle-class
микроб	microbe
миндаль (m)	almonds; almond tree	m; g sg миндаля
минимальный	minimum (adj)
многозначительно	meaningfully
молот	hammer
мольба	entreaty	no g pl
монархический	monarchic
монопольный	monopoly (adj)
мотаться (i)	to sway; rush about (coll)
моторный	motor, engine (adj)
мотоцикл	motorcycle
мошенник	swindler
мудрец	wise man	g sg мудреца
музейный	museum (adj)
мусорный	rubbish (adj)
мчать (i) (+a)	to rush, speed along	i мчу, мчишь
навес	awning
навещать/навестить (+a)	to visit
мясной	meat (adj)
нагрянуть (р)	to come unexpectedly (coll)
надбавка	addition, supplement	g pl надбавок
наёмный	hired
накапливаться/накопиться	to accumulate
наклон	incline, lean
наподобие (+g)	like, resembling
наполняться/наполниться (+inst)	to fill (with)
нарастание	growth, increase
населять/населить (+a)	to populate	i населяю
наследственный	inherited
насовсем	for good, for ever (coll)	= навсегда
наставник	mentor, tutor
натворить (р) (+g)	to get up to, do (sth bad) (coll)
наталкиваться/натолкнуться (на +a)	to run into, come up
нахальство	against impudence
наяву	while awake; for real	сон наяву daydream
небосклон	horizon
невмешательство (в +a)	non-interference (in)
невозможность (f)	impossibility	f
наугад	at random
невольный	involuntary
недостойный	unworthy
нежели	than (old word) (= чем)	= чем
незаконно	illegally
нездоровый	unhealthy
некого (+inf)	there is no-one	Некого спросить There’s no-one to ask
нелепо	absurdly; it’s absurd	Ей не с кем играть She has no-one to play with
неповторимый	unique, exceptional
непостижимый	incomprehensible
неправый	wrong	short forms неправ m, неправа f, неправы pl
непривычный	unaccustomed, unusual
неприкосновенный	untouchable, inviolable
непроходимый	impassable; (coll) utter
несравненно	incomparably
нетерпеливый	impatient
неудачно	unsuccessfully
неуместный	inappropriate, misplaced
нефтепровод	oil pipeline
нехотя	unwillingly; unintentionally
ничтожество	nonentity
новизна	novelty, newness
ножик	small knife, penknife
ножницы (pl)	scissors	g pl ножниц
нора	burrow	nom pl норы, g pl нор, d pl норам
носик	small nose; toe (of shoe); spout
ночлег	spending the night, night’s lodging
ноша	burden
обводить/обвести (+a)	to take round; (+inst) surround (with)	i обвожу, обводишь
обитатель (m)	inhabitant	m
облезлый	shabby, scruffy; mangy (coll)
обнаружение	revealing; discovery
обоснование	basis; grounds, justification
обосновывать/обосновать (+a)	to substantiate, justify	p обосную, обоснуешь
обострять/обострить (+a)	to intensify, worsen, aggravate	i обостряю
образный	graphic, evocative; figurative
обувать/обуть (+a)	to put shoes on s.o.; provide with shoes	p обую, обуешь
обходительный	courteous, well-mannered
общеизвестный	well-known, generally known
община	community	крестьянская община peasant commune (hist); о́бщи́на [either stress]
объективность (f)	objectivity	f
обыватель (m)	man-in-the-street; philistine	m
обыск	(official) search
овация	ovation
оголённый	bare, exposed
огорчение	distress
огорчать/огорчить (+a)	to distress, disappoint
одёргивать/одёрнуть (+a)	to straighten (clothing); (coll) call to order, tell s.o. to be quiet
одиннадцатый	eleventh
одиночный	individual, single, solitary	одиночный образ жизни solitary lifestyle
озираться (i)	to look round
злиться/о-	to get angry (coll)
озлобленный	embittered
ознакомление (с +inst)	familiarization, getting to know
оказание	rendering	оказание помощи assisting
оккупировать (i/p) (+a)	to occupy	i/p оккупирую
оперный	opera (adj), operatic
опоздание	lateness
ориентироваться (i/p)	to find one’s way; (на +a) be orientated towards	i/p ориентируюсь
осведомляться/осведомиться (о +pr)	to enquire about	p осведомлюсь, осведомишься
освещаться/осветиться	to be illuminated, light up
оснащение	equipping; equipment
основательный	well-founded; solid; thorough
отбиваться/отбиться (от +g)	to break away from; repulse, beat off; stray
отопление	heating
печатать/от- (+a)	to print (off)	печатать/отпечатывать i
отправка	sending off, dispatch
отрекаться/отречься (от +g)	to renounce (sth)	p отрекусь, отречёшься, отрекутся, past отрёкся, отреклась
отрубать/отрубить (+a)	to chop off	p отрублю, отрубишь
отставание	lag, lagging behind
отстранять/отстранить (+a)	to push aside; remove
охлаждать/охладить (+a)	to cool
пакость (f)	dirty trick; filth	f
пальчик	small finger
паршивый	mangy; shabby, nasty
перегонять/перегнать (+a)	to outdistance, outstrip; drive (sth swh); distil	p перегоню, перегонишь
передвигать/передвинуть (+a)	to shift
переделывать/переделать (+a)	to remake, alter
передник	apron; pinafore
переезд	crossing; removal (change of residence)
переигрывать/переиграть (+a)	to play again; overact
переливаться/перелиться	to flow (swh); overflow; (i only) glisten, play (of colours), modulate
перелом	break, fracture; turning-point
перенос	transfer, carrying over; hyphenation
переносный	portable; metaphorical
переписывать/переписать (+a)	to rewrite; copy out	p перепишу, перепишешь
переправа	crossing; crossing place ford
переселяться/переселиться	to move, migrate
переставлять/переставить (+a)	to shift; rearrange	i переставляю
переть (i)	to shove, barge, push (coll)	i пру, прёшь, past пёр, пёрла
перехватывать/перехватить (+a)	to intercept
перец	pepper
персона	person	обед на десять персон dinner for ten
писательский	writer’s, literary
плавный	smooth, flowing
планомерный	planned, systematic
плачущий	tearful
племенной	tribal; thoroughbred
плоть (f)	flesh	f
пляска	dance	g pl плясок
поблизости	nearby; hereabouts
поборник (+g)	champion, keen supporter (of)
побуждение	motive, stimulus
повадка	habit, (habitual) behaviour (coll)	g pl повадок
повозка	cart, carriage	g pl повозок
подача	giving; serve (tennis)	подача топлива fuel supply; подача помощи assistance
подбрасывать/подбросить (+a)	to throw, toss (up); jolt; add	p подброшу, подбросишь
подвигать/подвинуть (+a)	to move
пользование (+inst)	use (of sth)
поначалу	at first (coll)
подножие/подножье	foot (of mountain etc.); pedestal
подоконник	window-sill
подслушивать/подслушать (+a)	to eavesdrop (on s.o.); (p) overhear
подъёмный	lifting (adj)	подъёмный кран crane; подъёмный мост drawbridge
жевать/по- (+a)	to chew	p пожую, пожуёшь
жечь/по- (+a)	to burn up	p пожгу, пожжёшь, пожгут, past пожёг, пожгла
позорно	disgracefully, shamefully
полосатый	striped
полыхать (i)	to blaze
помалкивать (i)	to keep quiet (coll)
помещичий	landowner’s (adj)	f помещичья, п помещичье
помост	platform, rostrum; scaffold
понижать/понизить (+a)	to lower; reduce	p понижу, понизишь
обещать/по- (+a +d)	to promise (sth to s.o)
пополнение	replenishment; reinforcement(s)
попутчик	fellow-traveller
поровну	equally
порожний	empty (coll)
ругаться/по-	to swear; (c +inst) (coll) have a row with
послезавтра	the day after tomorrow
постный	lenten, meatless; without meat or milk; (coll) lean (of meat); (coll) gloomy, glum; (coll) sanctimonious
постукивать (i)	to knock, tap, patter
потомство	posterity, descendants
потреблять/потребить (+a)	to consume	i потребляю
пребывать (i)	to be (swh)	i пребывать у власти to be in power
превосходно	splendidly
предписание	order, instruction
предприниматель (m)	entrepreneur, businessman	m
преобладать (i)	to predominate
преступный	criminal (adj)
приветливый	affable, friendly
пригородный	suburban
придвигаться/придвинуться (к +d)	to come near, move up
придерживать/придержать (+a)	to hold back, check
приёмная	waiting-room
признанный	acknowledged, recognized
примечательно	(it is) noteworthy
примирение	reconciliation
припадок	fit, attack	припадок гнева fit of anger
припасы (m pl)	stores, supplies; provisions	m pl; g pl припасов
присягать/присягнуть (в +pr +d)	to swear an oath (of sth to s.o.)	i присягать в верности to swear an oath of loyalty
пробел	blank, gap	пробел в знаниях gap in one’s knowledge
пробивать/пробить (+a)	to pierce	p пробью, пробьёшь
провокатор	agent provocateur; provoker
греметь/про-	to thunder, resound	p прогремлю, прогремишь
прогуливаться/прогуляться	to take a walk	p прогуляюсь
демонстрировать/про- (+a)	to demonstrate, show	p продемонстрирую;
прозывать/прозвать (+a +inst)	to nickname (s.o. sth)	p прозову, прозовёшь, f past прозвала
промах	miss; blunder
промежуточный	intermediate
пронзительно	piercingly; stridently
пропагандировать (i) (+a)	to propagandize, promote	i пропагандирую
пропорциональный	proportional
просыпать/проспать	to oversleep	p просплю, проспишь, f past проспала
простираться/простереться	to extend, stretch
просторно	(it is) spacious
простужаться/простудиться	to catch a cold	p простужусь, простудишься; простуживаться i or простужаться i
протирать/протереть (+a)	to rub; rub through
протягиваться/протянуться	to stretch out; extend	p протянусь, протянешься
прохвост	scoundrel (coll)
прохождение	passing, passage
процветать (i)	to flourish	no p
прояснение	clarification, clearing up; clear period (weather)
прутик	twig, switch; small rod
пчела	bee	nom pl пчёлы
пшено	millet
пьянка	binge, booze-up (coll)	g pl пьянок
пята	heel	nom pl пяты, g pl пят, d pl пятам
разбегаться/разбежаться	to scatter; take a run-up	p разбегусь, разбежишься, разбегутся
разведывательный	reconnaissance (adj); intelligence (adj)	разведывательная служба intelligence service
развешивать/развесить (+a)	to hang up (a number of things); weigh out	p развешу, развесишь;развесить бельё to hang out the washing
раздробленный	shattered, splintered, disunited
разливаться/разлиться	to spill; overflow
различаться (i) (+inst)	to differ
размещение	placing, allocation, accommodation
разнородный	heterogeneous
разгонять/разогнать (+a)	to disperse	p разгоню, разгонишь, f past разогнала
разорять/разорить (+a)	to ruin
разочарованный	disappointed, disillusioned
разыгрываться/разыграться	to romp; warm up, get into one’s stride; (storm etc.) break, rage
расизм	racism
раскусывать/раскусить (+a)	to bite through; (p only) (coll) suss out; get to the heart of sth	p раскушу, раскусишь
распоряжаться/распорядиться	to give orders; (+inst) deal with, manage, be in charge of	p распоряжусь, распорядишься
расстилаться/разостлаться	to spread out
расстройство	disorder
рассыпать (i/p) (+a)	to spill, scatter	рассыпа́ться/рассы́паться; p рассыплю, рассыплешь
растительность (f)	vegetation	f
реалистический	realistic
ребячий	child’s; childish	f ребячья, п ребячье
ревнивый	jealous
ремесленник	craftsman; hack
решето	sieve	nom pl решёта; Чудеса в решете! Incredible!
рогожа	matting
рожок	small horn; horn (instrument)
романс	romance (song)
рыночный	market (adj)	рыночная экономика market economy
салют	salute; firework display (in honour of s.o. or sth)
самокритика	self-criticism
самосознание	self-awareness
сберегать/сберечь (+a)	to save; protect	p сберегу, сбережёшь, сберегут, past сберёг, сберегла
свешивать/свесить (+a)	to lower, let dangle; (p only) (coll) weigh	p свешу, свесишь
сенсация	sensation
сентябрьский	September (adj)
сервиз	service, set (of dishes)
серийный	serial	серийное производство mass production
сидение	sitting; (preferably сиденье) seat
синяк	bruise	g sg синяка
скалистый	rocky
скандальный	scandalous; (coll) quarrelsome, rowdy
скорбь (f)	grief	f; g pl скорбей
скромно	modestly
скромность (f)	modesty	f
слать/по- (+a)	to send	i шлю, шлёшь
словцо	word; apt remark, witticism (coll)	для красного словца for effect
слуга (m)	servant	m; nom pl слуги
смешить (i) (+a)	to make (s.o.) laugh, amuse
смешок	chuckle	смешки jeers, jokes
смутно	vaguely, dimly
снаряжать/снарядить (+a)	to equip	p снаряжу, снарядишь
снисходительно	condescendingly; leniently, indulgently
снисходительный	condescending; lenient, indulgent
совершенствоваться/у- (в +pr)	to improve os; improve one’s knowledge (of)	i совершенствуюсь
содержательный	rich in content, profound, interesting
солдатик	toy soldier
солидно	solidly, substantially, weightily
сооружать/соорудить (+a)	to build, construct	p сооружу, соорудишь
соотечественник	compatriot
сопоставлять/сопоставить (+a)	to compare	p сопоставлю, сопоставишь
сопутствовать (i) (+d)	to accompany	i сопутствую
сорока	magpie
соседский	neighbour’s
сосредоточенно	intently, with concentration
составление	formation, making, compiling	составление словаря compilation of a dictionary
сосулька	icicle	g pl сосулек
спешка	haste
спрыгивать/спрыгнуть (с +g)	to jump off
срезать (i/p) (+a)	to cut down, cut off; shut s.o. up	среза́ть/сре́зать; p срежу, срежешь
стаканчик	small glass
стачка	strike (= забастовка)	g pl стачек
стекольщик	glazier
стенной	wall (adj)
стойко	steadfastly
странствовать (i)	to wander, travel	i странствую
стрелковый	shooting (adj); rifle, infantry (adj)	стрелковый тир rifle range
стружка	shaving, shavings	g pl стружек
струиться (i)	to stream
стычка	skirmish; squabble	g pl стычек
судорожно	convulsively, feverishly
сука	bitch
сукно	cloth	nom pl сукна, g pl сукон
сумрачный	gloomy; dreary
сухарь (m)	piece of dried bread; rusk	m; g sg сухаря
сюжет	subject, plot
тайник	hiding-place	g sg тайника
танкист	tank soldier, member of tank crew
территориальный	territorial
тесниться (i)	to crowd, jostle
тётушка	auntie; (old) lady	g pl тётушек
титул	title
тиф	typhus
токарь (m)	turner, lathe operator	nom pl (formal) токари, nom pl (coll) токаря
толковый	clever, sensible; clear, comprehensible; (словарь) explanatory
торжествовать (i) (над +inst)	to triumph (over); (+a) celebrate	i торжествую
трезво	soberly
триумф	triumph
трогательный	touching, affecting
трюк	stunt; trick, ruse
тугой	tight
туризм	tourism; hiking
турок	Turk	g pl турок
тысячелетний	thousand-year (adj)
тягость (f)	burden	f
увесистый	weighty
удостаивать/удостоить (+a +g)	to award s.o. sth; (+a +inst) favour s.o. with sth
уклоняться/уклониться (от +g)	to avoid, evade (sth)	i уклоняюсь; уклоняться от ответа to dodge a question, avoid answering
укореняться/укорениться	to take root
укрепляться/укрепиться	to become stronger; become fixed; consolidate one’s position	i укреплюсь, укрепишься
универсальный	universal; versatile, multi-purpose	универсальный магазин department store
униматься/уняться	to calm down
упоминаться/упомянуться	to be mentioned
упорядочение	putting in order, regulation
управа	(coll) control, means of control; (hist) management, administration, justice
упрощённый	simplified; over-simplified
упрямство	obstinacy
усеивать/усеять (+a +inst)	to strew, dot, litter (sth with sth)	p усею, усеешь
устранение	removal, elimination
утверждаться/утвердиться	to become established
утешение	comfort, solace
утюг	iron (for ironing)	g sg утюга
уха	fish-soup
финал	final (sport); finale
финиш	finish
финский	Finnish
формация	stage of development; formation
хилый	puny, decrepit
хирург	surgeon
христианство	Christianity
хроника	chronicle; news items; newsreel
царапать/царапнуть (+a)	to scratch
целесообразный	expedient
целеустремлённый	purposeful
цивилизованный	civilized
цыган	gypsy	nom pl цыгане, g pl цыган
челюсть (f)	jaw	f
чередование	alternation
четыреста	four hundred	g четырёхсот
чешский	Czech (adj)
чистка	cleaning; purge (political)	g pl чисток
читательский	reader’s
чихать/чихнуть	to sneeze
чрезмерно	excessively
шататься (i)	to sway; wobble; (coll) loaf about
шаткий	unsteady
шахматы (pl)	chess	g pl шахмат
швейный	sewing
шевелиться/шевельнуться	to stir
шелуха	skin, peel, husk
шершавый	rough (to the touch)
шириться (i)	to spread, expand
шишка	(pine/fir) cone; bump; (coll) big noise, VIP	g pl шишек
шляться (i)	to loaf about (coll)	i шляюсь
шпора	spur
штаб-квартира	headquarters
штормовой	gale (adj)
щедрость (f)	generosity	f
щенок	puppy	поm pl щенки, g pl щенков or nom pl щенята, g pl щенят
электроника	electronics
эффектный	striking, done for effect
яичница	fried eggs
ярмарка	fair, trade fair	g pl ярмарок
авианосец	aircraft carrier
автономный	autonomous
азарт	excitement, fervour
азбука	alphabet
акула	shark
алкоголь (m)	alcohol	m
аренда	lease
бабочка	butterfly	g pl бабочек
багаж	luggage	g sg багажа
бак	cistern, tank
барахло	old clothes, jumble; junk (coll)
бдительный	vigilant
бедро	hip; thigh	nom pl бёдра, g pl бёдер
бездействовать (i)	to do nothing; stand idle	i бездействую
безответственный	irresponsible
безропотно	uncomplainingly, without a murmur
беспечный	carefree, unconcerned
бестолковый	stupid; incoherent, muddled
бинт	bandage	g sg бинта
блоха	flea	nom pl блохи, g pl блох, d pl блохам
болтаться (i)	to dangle; hang about (coll)
бритва	razor
буйный	wild, unruly
быль (f)	true story, fact	f
бюллетень (m)	bulletin; ballot-paper; medical certificate	m
вдыхать/вдохнуть (+a)	to breathe in
величавый	majestic
веха	landmark; stake, marker
взнос	payment; fee; subscription
вилка	fork; (two-pin) plug	g pl вилок
виселица	gallows
внятно	distinctly, clearly, audibly
водружать/водрузить (+a)	to hoist, erect	p водружу, водрузишь
воздерживаться/воздержаться (от +g)	to abstain (from)	p воздержусь, воздержишься
вонять (i) (+inst)	to stink (of)	i воняет
воодушевление	enthusiasm, fervour
воочию	with one’s own eyes, for os	воочию убедиться в +pr to see for os
ворох	heap, pile	nom pl вороха; ворох сена pile of hay; ворох новостей heaps of news
воск	wax
вторгаться/вторгнуться (в +a)	to invade
выручка	proceeds, earnings; rescue
выступ	projection; ledge
вышка	tower; turret	g pl вышек
вялый	flabby, limp
договорённость (f)	agreement	f
гнить/с-	to rot	i гнию, гниёшь, f past гнила
гнусный	vile
горб	hump	g sg горба, pr sg на горбу
град	hail; (poet) city
гусеница	caterpillar
дань (f)	tribute, homage	f
девать/деть (+a)	to put (coll)
добродетель (f)	virtue	f
домысел	conjecture
дощатый	made of planks, board (adj)
духи (m pl)	perfume	m pl; g pl духов
душистый	fragrant
евангелие	gospel
еврей	Jew
единогласно	unanimously
ёж	hedgehog	g sg ежа
жанр	genre
жарить/за- (+a)	to fry; roast
жемчужина	pearl
жир	fat, grease	pr sg в жиру, nom pl жиры
жуткий	terrible
завсегдатай	habitue; regular customer
заглавие	title, heading
загс	registry office
задор	fervour, vigour
заём	loan	g sg займа
закоулок	back alley; nook, cranny
залог	deposit, guarantee, pledge
замешательство	confusion; consternation
замкнутый	reserved, unsociable; secluded, private
заочно	in one’s absence; externally (of study for a degree)	окончить институт заочно to take an external degree
запинаться/запнуться	to stumble
запчасть (f)	spare part	f
застёгивать/застегнуть (+a)	to fasten
изрядный	fairly good, quite large	изрядное количество quite a lot
захлёбываться/захлебнуться	to choke
злоупотреблять/злоупотребить (+inst)	to misuse, abuse (sth)	i злоупотребляю
знатный	distinguished, outstanding; (hist) high-born, noble
зонтик	umbrella
зыбкий	unsteady, unstable
ива	willow
икра	caviare; calf (of leg)
искажать/исказить (+a)	to distort
искушение	temptation
исподволь	gradually (coll)
калека (m/f)	cripple	m/f
камыш	reed, rush	g sg камыша
карий	brown, hazel (of eyes); chestnut (of horses)	soft adj
квитанция	receipt
клевать/клюнуть	to peck	i клюю, клюёшь; клевать носом to nod, be drowsy
клей	glue
клумба	flower-bed
коврик	rug
коготь (m)	claw	m; g pl когтей
кое-как	anyhow, carelessly; somehow or other, somehow
коренастый	thickset, stocky
косой	slanting, oblique, squint; cross-eyed, squinting
красноречие	eloquence
крушение	wreck, ruin, collapse
кувыркаться/кувыркнуться	to turn somersaults, go head over heels
кумир	idol
кутёж	drinking-bout	g sg кутежа
лазейка	hole; loop-hole	g pl лазеек
лак	varnish
ласточка	swallow	g pl ласточек
лезвие	blade
лестный	flattering
ликовать (i)	to rejoice	i ликую
лицемерие	hypocrisy
льстить/по- (+d)	to flatter	i льщу, льстишь
мазать (i) (+a)	to grease, smear	i мажу, мажешь
маяк	lighthouse; beacon	g sg маяка
мерзость (f)	vileness; sth disgusting	f
мести (i) (+a)	to sweep	i мету, метёшь, past мёл, мела
мизинец	little finger; little toe
миска	bowl	g pl мисок
мозоль (f)	corn (on foot), callous	f
мятеж	rebellion	g sg мятежа
набросок	sketch, rough draft
наизусть	by heart, from memory	выучить наизусть to learn by heart
наперекор (+d)	contrary, counter (to), in defiance (of)	наперекор судьбе in defiance of fate
нарекание	reprimand
насаждение	planting; propagation
насморк	cold (in the head)
начинка	stuffing, filling (of pie etc.)
невестка	daughter-in-law; sister-in-law (brother’s wife)	g pl невесток
незваный	uninvited
незыблемый	unshakable
неистовый	frenzied
неполадка	fault, defect	g pl неполадок; неполадки (coll) quarrel
непринуждённый	relaxed, unconstrained
неразбериха	muddle (coll)
несовместимый	incompatible
неспроста	with an ulterior motive, not without a reason (coll)
неурядица	confusion (coll)	неурядицы squabbling
ничей	nobody’s	f ничья, n ничьё; ничья drawn game; ничья земля no man’s land
нрав	nature, disposition (of person)	тихий нрав quiet nature; нравы manners, customs
ныть (i)	to whine, complain; ache	i ною, ноешь
нюхать/по- (+a)	to smell, sniff (sth)
обаяние	charm
обуздывать/обуздать (+a)	to curb, restrain	p обуздаю
озабоченный	worried, preoccupied
олень (m)	deer	m
омерзительный	disgusting, revolting
омут	pool, deep place in river; whirlpool	В тихом омуте черти водятся Still waters run deep
опека	guardianship, trusteeship; surveillance, care
опилки (pl)	sawdust; metal filings	g pl опилок
оплошность (f)	slip, blunder	f
оправа	mounting, frame
опрятный	tidy, neat
оспаривать/оспорить (+a)	to contest, dispute
отборный	selected, specially chosen
отделываться/отделаться (от +g)	to get rid of; (+inst) get off, escape (with)	p легко отделаться to get off lightly
отменный	excellent
отравлять/отравить (+a)	to poison	i отравляю
ошеломлять/ошеломить (+a)	to stun, astound	p ошеломлю, ошеломишь
пакетик	bag, plastic bag
палисадник	front garden; stake fence
панель (f)	pavement; panelling, panel	f
пасмурный	cloudy, overcast; gloomy
пасынок	stepson
пекло	scorching heat; hell (coll)
пелёнка	nappy, diaper	g pl пелёнок
передышка	breathing-space, rest, short break	g pl передышек
перечень (m)	list, enumeration	m
перина	feather-bed, duvet
перрон	platform (railway station)
пир	feast	pr sg в/на пиру, nom pl пиры
пирожное	cake, pastry
пищать/пискнуть	to squeak, squeal; cheep	i пищу, пищишь
пластмасса	plastic
плесень (f)	mould
плескать/плеснуть	to splash	i плещу, плещешь
печень (f)	liver	f
пляж	beach
побуждать/побудить (+a +inf or к +d)	to prompt, induce (s.o. to do sth)	p побужу, побудишь
подданный	subject, citizen
подошва	sole (of shoe, foot)
подсобный	subsidiary, supplementary
позитивный	positive
поклонник	admirer
покорять/покорить (+a)	to conquer, subjugate	i покоряю
половой	sexual
полтораста	a hundred and fifty	g/d/inst/pr полутораста
поместье	estate	g pl поместий
помидор	tomato
поощрять/поощрить (+a)	to encourage	i поощряю
пополам	in half, half-and-half	с грехом пополам after а fashion, only just
поросёнок	piglet	nom pl поросята, g pl поросят
портной	tailor
пословица	proverb
послушный	obedient
поставлять/поставить (+a)	to deliver, supply	i поставляю
потеха	fun, amusement
похмелье	hangover	быть с похмелья to have а hangover
почесть (f)	honour, mark of respect	f
пошлый	vulgar; trivial, banal
православный	orthodox (religious term); (as noun) member of Orthodox Church	православная церковь Orthodox Church
прадед	great-grandfather
праздность (f)	idleness	f
предосудительный	reprehensible
пресный	unsalted; flavourless, bland	пресная вода fresh water
придираться/придраться (к +d)	to find fault with
приемлемый	acceptable
признательный	grateful
прикидываться/прикинуться (+inst)	to pretend (to be sth) (coll)
приют	shelter, refuge
проворный	quick, agile
пролив	strait
проницательный	penetrating; shrewd
просо	millet
пруд	pond	g sg пруда, pr sg в пруду
птенец	nestling, fledgling
пух	down, fluff	pr sg в пуху
пыл	heat, ardour	pr sg в пылу
пылесос	vacuum cleaner
развод	divorce
раздолье	expanse, open space; freedom
разительный	striking	разительное сходство striking similarity
разлад	discord; disorder
разрозненный	incomplete (of set); scattered, uncoordinated	разрозненный комплект broken set; разрозненные выстрелы isolated shots
разыгрывать/разыграть (+a)	to perform; raffle, draw lots (for sth); play a trick (on s.o.), fool
раскат	rumble, roll, peal	раскат грома rumble of thunder; раскаты хохота loud peals of laughter
раскаяние	repentance
рассудок	reason, ability to think	голос рассудка the voice of reason; лишиться рассудка to go out of one’s mind
растрёпанный	dishevelled; tattered
ринуться (р)	to rush, charge, dash	no i
рознь (f)	difference; discord, disagreement	f
рокот	roar, rumble
рукавица	mitten, glove (without fingers)
рыдать (i)	to sob
сверстник	person of the same age, contemporary
селёдка	herring	g pl селёдок; dim of сельдь f herring
сквер	public garden
сквозняк	draught	g sg сквозняка
скитаться (i)	to wander, roam
скорлупа	shell	nom pl скорлупы; яичная скорлупа eggshell
скрежет	grinding (noise)
слыть/про- (+inst or за +a)	to have the reputation of, be considered	i слыву, слывёшь; Он слывёт чудаком Не is considered eccentric
слюна	saliva	also in the form слюни pl, g pl слюней
смежный	adjacent, adjoining, connected	смежные комнаты adjoining rooms
смета	estimate
смятение	confusion, disarray, panic
мять/с- (+a)	to crumple, crush	p сомну, сомнёшь
сновать (i)	to dash about, scurry	i сную, снуёшь
сноровка	knack, skill	Необходимо иметь сноровку You have to have the knack
соблазнять/соблазнить (+a)	to tempt; seduce
соловей	nightingale	g sg соловья, g pl Соловьёв
сплетни (f pl)	gossip	f pl; nom sg сплетня; g pl сплетен
справочник	reference book, guide
стаж	period of service, period of work or training	производственный стаж industrial experience
стужа	icy cold, severe frost (coll)
сутулый	round-shouldered, stooping
сшибать/сшибить (+a)	to knock down (coll)	p сшибу, сшибёшь, past сшиб, сшибла; сшибить кого-нибудь с ног to knock s.o. off their feet
таз	basin; pelvis	pr sg в тазу or в тазе, nom pl тазы
талон	coupon
тёща	mother-in-law (wife’s mother)
тлеть (i)	to rot; smoulder	i тлеет
тщетно	in vain
уйма (+g)	lots (of) (coll)	no pl
умеренный	moderate
упругий	elastic, springy
урод	freak, monster
усмотрение	discretion, judgement	по вашему усмотрению as you think best
утечка	leak	g pl утечек
утомительный	tiring; tedious
ухмыляться/ухмыльнуться	to smirk, grin (coll)	i ухмыляюсь
фея	fairy
хлопья (pl)	flakes	g pl хлопьев
чаяние	hope; expectation
чесать/по- (+a)	to scratch	i чешу, чешешь
чтить/по- (+a)	to honour	i чту, чтишь
шаблон	cliche; routine; pattern
шаркать/шаркнуть (+inst)	to shuffle	i шаркать ногами to shuffle one’s feet
шествие	procession
шнур	cord; lace; flex, cable	g sg шнура
штабель (m)	stack, pile	m; nom pl штабеля
шустрый	smart, quick, agile (coll)
щекотать/по- (+a)	to tickle	i щекочу, щекочешь
щетина	bristles, bristly surface; stubble (of beard)
щука	pike (fish)
щупать/по- (+a)	to feel, touch (sth), probe
щуриться/со-	to screw up one’s eyes, narrow one’s eyes
электричка	suburban train (coll)	g pl электричек
этажерка	bookcase	g pl этажерок
ярый	furious, raging; fervent, rabid	ярый поклонник fervent admirer
#METADATA:
#--columns russian,english,extra
#--listdelimiter |
