слышать/у- (+a)	to hear	Вы меня слышите?|Can you hear me?; p: услышу, услышишь
ухо	ear	nom pl уши, g pl ушей
шум	noise, din
аппарат	apparatus
гораздо	much (with comparatives)	гораздо лучше much better
капитал	capital (financial)
плохой	bad
площадь (f)	square; area	g pl площадей
поезд	train	nom pl поезда
профессор	professor	nom pl профессора
серьёзно	seriously
соль (f)	salt	g pl солей
сон	sleep; dream	g sg сна
тень (f)	shade; shadow	pr sg в тени, g pl теней
гражданин	citizen	nom pl граждане, g pl граждан
доставать/достать (+a)	to get, obtain; take out; reach	i достаю, достаёшь; p: достану, достанешь
дурак	fool	g sg дурака
ибо	for (because)
лошадь (f)	horse	g pl лошадей, inst pl лошадьми, pr pl лошадях	deck#3	due@2020-10-06 11:48:47
пшеница	wheat
столько (+g)	so much, so many
эпоха	epoch, age
давай(те)	let’s (do sth)	(+1st person pl р or i inf) Давайте выпьем Let’s have a drink
беда	misfortune	pl беды ; беда в том, что ... the trouble is that...
дальний	distant, remote
закрывать/закрыть (+a)	to close, shut; to cover	p: закрою, закроешь
звезда	star	nom pl звёзды, g pl звёзд
обычный	usual
проводить/провести (+a)	to lead, conduct; spend (time)	i: провожу, проводишь; p: проведу, проведёшь, past провёл, провела
разговаривать (i)	to converse, talk
размер	size, scale, extent	размеры proportions, dimensions	deck#2	due@2020-09-30 11:54:15
разрешать/разрешить (+d of person)	to allow, permit; solve	p: разрешу, разрешишь
нечего	there is nothing	d нечему; inst нечем; pr не о чем; Нечего делать There is nothing to do	deck#2	due@2020-09-30 11:46:58
атмосфера	atmosphere
лодка	boat, rowing boat	g pl лодок
название	name; title (book)
правильный	correct, right
пустой	empty
сапог	boot; jackboot	g sg сапога; g pl сапог
скорее	quicker; rather	скорее всего most probably
дальнейший	further	в дальнейшем henceforth
журнал	magazine, periodical; journal, register
либо	or	либо ..., либо either..., or
телевизор	television (set)	смотреть телевизор to watch television
ракета	rocket
способность (f)	ability
академия	academy
впечатление	impression
древний	ancient
иметься (i)	to be, be available	(3rd pers only) имеется, имеются
ожидать (i) (+a or +g)	to wait (for); to expect	no p
пароход	steamer
разоружение	disarmament
след	footprint; trace, vestige	nom pl следы
удар	blow, strike
внешний	exterior	внешняя политика foreign policy
нож	knife	g sg ножа	deck#3	due@2020-10-06 11:47:08
грудь (f)	breast	pr sg о груди в груди, g pl грудей
крайний	extreme
моряк	sailor	g sg моряка
наоборот	on the contrary, vice versa, the other way round
передовой	advanced; progressive	передовая статья leading article
принцип	principle
тайна	secret, mystery
тихий	quiet, calm
устанавливать/установить (+a)	to set up, establish	p: установлю, установишь
электрический	electric
верный	faithful, correct, reliable, sure
ворота (nom pl)	gate, gates	g pl ворот
дворец	palace	g sg дворца
золото	gold
открытие	opening; discovery
отсюда	from here; hence
специалист	specialist
длина	length	длиной в два метра two metres long
наблюдать (i) (+a)	to observe, watch	за +inst to watch over
немедленно	immediately, forthwith
немецкий	German (adj)
повышение	rise, increase; promotion
получаться/получиться	to turn out, work out, result	p: получится
соглашаться/согласиться	to agree (c +inst) with, (на +a) to	p: соглашусь, согласишься
участие	participation; sympathy	принимать участие в +pr to take part in
весело	merrily, cheerfully	Нам было весело We enjoyed ourselves
левый	left; left-wing
московский	Moscow (adj)
постоянный	constant, permanent	постоянный адрес permanent address
приказ	command, order	отдать приказ to issue an order
роман	novel; love affair, romance
смех	laughter, laugh
твёрдый	hard, firm, solid
тон	tone, musical tone; colour tone, tint	(nom pl тоны, g pl тонов) tone, musical tone; (nom pl тона, g pl тонов) colour tone, tint
абсолютно	absolutely
деталь (f)	detail; component (of machine)
объём	volume, capacity, size
интересно	interestingly; it is interesting
книжка	(small) book	g pl книжек; записная книжка notebook
курс	course, course of study; rate of exchange
почва	soil
низкий	low	deck#2	due@2020-09-30 11:49:03
очевидно	obviously
пыль (f)	dust	pr sg о пыли, в пыли
светлый	light, bright	светлая комната light room
серый	grey	серый волк grey wolf
анализ	analysis
влияние	influence	оказать влияние на +а to influence s.o. or sth
молчать/по-	to be silent for a while	p: помолчу, помолчишь
руководство	leadership; guide, manual
атомный	atomic	атомная электростанция atomic power station
граница	frontier; limit	за границей abroad
защита	defence	no pl; в защиту кого-нибудь in defence of s.o.
кусок	piece	g sg куска; кусок сахара sugar lump
молчание	silence	Молчание - знак согласия Silence gives consent	deck#2	due@2020-09-30 11:56:32
наверное	probably
неожиданно	unexpectedly
пара	pair, couple	пара сапог a pair of boots
платок	shawl, kerchief	g sg платка; носовой платок handkerchief
практический	practical	практический опыт practical experience
предел	limit	в пределах +g within
стенка	wall, partition, side	g pl стенок; стенки трубки sides of a tube	due@2020-09-29 11:49:27
существо	essence; being, creature	живое существо living creature
тишина	quiet, silence	нарушить тишину to break the silence
товар	commodity, article	товары широкого потребления consumer goods
вершина	summit, peak	вершина горы mountain peak
взрыв	explosion	произвести взрыв to cause an explosion
виноватый	guilty, to blame	Он не виноват It’s not his fault
вырастать/вырасти	to grow, increase	p вырасту, вырастешь, past вырос, выросла
гражданский	civil, civic	гражданская война civil war
деятель (m)	agent, figure	государственный деятель statesman
дождь (m)	rain	g sg дождя; под дождём in the rain
называться/назваться	to be called
невозможно	impossibly; it is impossible	Его невозможно найти Не can’t be found
обещать (i/p) (+d)	to promise (s.o.)	р also по-
позволять/позволить (+d)	to permit (s.o.)	i: позволяю, позволяешь; p: позволю, позволишь
роль (f)	role	nom pl роли, g pl ролей
сестра	sister	nom pl сёстры, g pl сестёр, d pl сёстрам, inst pl сёстрами, pr pl сёстрах
следовательно	consequently, therefore
столица	capital (city)	жить в столице to live in the capital
фигура	figure	стройная фигура shapely figure
царь (m)	tsar	g sg царя, inst sg царём
бедный	poor	бедные люди poor people
верхний	upper	верхняя полка upper berth
вслед (за +inst)	after	вслед за ним after him
изменение	change, alteration	внести изменения в +a to make changes in
носить (i) (+a)	to carry (around); wear	ношу, носишь; indet of нести i
особенность (f)	peculiarity, special feature	в особенности in particular
рад	glad (short adj)	f рада, pl рады
резко	sharply, abruptly	Погода резко изменилась There was a sharp change in the weather
звонок	bell, ring; telephone call	g sg звонка
испытание	test, trial; ordeal
необходимость (f)	necessity	no pl; В этом нет необходимости It is not essential
обстановка	environment, situation; furniture	no pl
печать (f)	seal, stamp; print, printing	свобода печати freedom of the press
повод	cause, grounds	к/для for; по поводу +g concerning, apropos of
постоянно	constantly, perpetually	Он постоянно недоволен He is always dissatisfied
разуметься (i)	to be meant	i: разумеется; под этим разумеется this implies; само собой разумеется it goes without saying
стакан	glass, tumbler	стакан чаю a glass of tea
точный	exact, precise	точный перевод exact translation
уезжать/уехать	to go away, leave (by transport)	p: уеду, уедешь
широко	widely, broadly	широко улыбаться to smile broadly
возможный	possible	возможные решения possible solutions
изучение	(detailed) study (of)	no pl; изучение природы study of nature
комиссия	commission, committee	deck#4	due@2020-10-29 11:48:38
гектар	hectare (10,000 square metres, 2.5 acres)
благодарить/по- (+a; за +a)	to thank (s.o. for sth)	i: Благодарю вас I thank you
блестящий	shining, bright, brilliant	блестящий ум brilliant mind
вес	weight	nom pl веса; вес пакета weight of a packet
врач	doctor	g sg врача; Она любит врачей She likes doctors
жёлтый	yellow
крик	cry, shout	крик восторга cry of joy	deck#2	due@2020-09-30 11:54:03
нынче	now (= теперь); today (coll)
обеспечивать/обеспечить (+a +inst)	to supply, provide (s.o. with sth); (+a) assure, guarantee	p: обеспечу, обеспечишь
поэт	poet
рот	mouth	g sg рта; pr sg во рту, о рте, nom pl рты, g pl ртов
собака	dog
соседний	neighbouring, next	соседняя комната next room
туман	fog, mist
капитан	captain
философия	philosophy
доказывать/доказать (+a)	to demonstrate, prove	p: докажу, докажешь
здоровье	health	Выпьем за её здоровье! Let’s drink to her health!
извинять/извинить (+a)	to pardon	p: Извините! I’m sorry!
ошибка	mistake	g pl ошибок; по ошибке by mistake
тотчас	immediately	Он тотчас уехал Не left at once
вагон	carriage, coach, wagon	вагон-ресторан restaurant car
гореть/за-	to burn, be alight	горю, горишь; Горел свет There was a light on
далёкий	distant, remote	далёкий город distant town
канал	canal; channel	дипломатические каналы diplomatic channels
практика	practice	разговорная практика conversation practice
сожаление	regret	к сожалению unfortunately
укрепление	strengthening	укрепление обороны strengthening of defence
быт	way of life, everyday life	pr sg в быту; служба быта consumer services
делаться/с- (+inst)	to become; be done
крыша	roof
недостаток	defect; (+g or в +pr) shortage (of)	g sg недостатка
отрасль (f)	branch (of science, industry, government, etc.)
подавать/подать (+a)	to give; serve (food); present	i: подаю, подаёшь; p: подам, подашь, подаст, подадим, подадите, подадут, past подал, подала, подало; подать пример to set an example
поиск	search	в поисках (+g) in search of
порт	port	pr sg в порту, о порте; nom pl порты, g pl портов
свидание	meeting, rendezvous	назначить свидание to arrange a meeting; до свидания goodbye
требование	demand
черта	feature, trait; line	провести черту to draw a line
штат	staff (of institution); state (of the USA, Australia)
вздыхать/вздохнуть	to sigh	p: вздохну, вздохнёшь	deck#2	due@2020-09-30 11:56:46
записка	note (written)	g pl записок; послать записку to send a note
озеро	lake	nom pl озёра, g pl озёр
организовать (i/p) (+a)	to organize	организую, организуешь; i in past организовывать
сознание	consciousness	классовое сознание class consciousness
тепло	warmly; it is warm; warmth	пять градусов тепла five degrees above zero
прежний	former
пространство	space, expanse	космическое пространство outer space
составлять/составить (+a)	to make up, compose, constitute	i: составляю, составляешь; p: составлю, составишь;
спутник	travelling companion; satellite
стрелять (i) (в +a or по +d)	to shoot (at)	i: стреляю, стреляешь
вдоль (+g)	along	вдоль реки along the river
встречаться/встретиться (с +inst)	to meet (s.o.)	p: встречусь, встретишься
документ	document
мечтать (i) (о +pr)	to (day) dream (about)
обычно	usually
продукт	product	продукты produce, provisions, food
секунда	second	через две секунды two seconds later
сельскохозяйственный	agricultural
странный	strange
братский	fraternal, brotherly	братские страны fraternal countries
доходить/дойти (до +g)	to reach (s.o. or sth)	i дохожу, доходишь; p: дойду, дойдёшь, past дошёл, дошла
достижение	achievement
заходить/зайти	(к +d) to call on s.o.; (за +a) go behind, set (of sun)	i захожу, заходишь; p: зайду, зайдёшь; past зашёл, зашла
мёртвый	dead
могучий	powerful	могучая армия powerful army
мотор	motor, engine	мотор автомобиля car engine
независимость (f)	independence	борьба за независимость independence struggle
представление	presentation; performance; notion, conception
применение	application, use
трудность (f)	difficulty
удовольствие	pleasure
узкий	narrow
боец	fighter, soldier	g sg бойца
жалко	pitifully; it’s a pity; (+g) be sorry for	Мне его жалко I’m sorry for him
массовый	mass (adj)
меньше	less
мечта	dream, daydream	no g pl
ночной	night (adj)
обратно	back (adv)	туда и обратно there and back
опасность (f)	danger
отказываться/отказаться (+inf)	to refuse (to do sth); (от +g) renounce (sth)	p: откажусь, откажешься
полк	regiment	g sg полка, pr sg в полку
полностью	fully, completely
попытка	attempt	g pl попыток
прошлое	the past
рис	rice
спокойный	calm
уголь (m)	coal	g sg угля, nom pl угли/уголья, g pl углей/угольев
учреждение	establishment, institution
щека	cheek	a sg щёку, g sg щеки, nom pl щёки, g pl щёк, d pl щекам
возраст	age
громко	loudly
дым	smoke	pr sg в дыму, nom pl дымы
желание	wish, desire
забота	care, trouble
использование	utilization
красота	beauty	nom pl красоты
мощный	powerful
постепенно	gradually
президент	president
рыба	fish
следить (i) (за +inst)	to watch, keep an eye on	i: слежу, следишь
хватать/схватить (+a)	to seize, grab	p: схвачу, схватишь; хватать i/схватывать i
темнота	darkness
трава	grass; herb	nom pl травы
тяжело	heavily; gravely; it is hard, painful
улучшение	improvement
улыбка	smile	g pl улыбок
учение	learning, study, instruction
глупый	stupid, silly
зато	in compensation, on the other hand	Дом далеко от центра, зато метро рядом The house is far from the centre, but (on the other hand) the metro is nearby
лоб	forehead	g sg лба, pr sg на лбу
немало	not a little, a good many
поколение	generation
учитель (m)	teacher	nom pl учителя
видимо	evidently
воевать (i)	to wage war	i: воюю, воюешь
выступление	speech; (public) appearance	deck#2	due@2020-09-30 11:56:40
юноша	(a) youth	g pl юношей
значительно	significantly, considerably
из-под (+g)	from under	из-под стола from under the table; бутылка из-под молока milk bottle
ложиться/лечь	to lie down	i: ложусь, ложишься; p: лягу, ляжешь, лягут, past лёг, легла, imperative ляг(те)!
пробовать/по-	(+inf) to try; (+a) test; taste	i пробую, пробуешь; p: попробую, попробуешь
промышленный	industrial
слабый	weak
стул	chair	nom pl стулья, g pl стульев
фотография	photograph
цепь (f)	chain	pr sg о цепи, на цепи, nom pl цепи, g pl цепей
восстание	uprising
задание	task, assignment
наверно	probably, most likely
обращаться/обратиться (к +d)	to turn to; (в +a) turn into; (c +inst) handle sth, treat s.o.	p: обращусь, обратишься
октябрь (m)	October	g sg октября
отличаться/отличиться	to distinguish os; (от +g i only) differ	i: Чем отличается университет от института? What’s the difference between a university and an institute?
повторять/повторить (+a)	to repeat	i: повторяю, повторяешь
содержание	content (noun)
устраивать/устроить (+a)	to arrange, organize (sth)
важно	it is important
вера	faith, belief	deck#2	due@2020-09-30 11:49:01
демократический	democratic
долг	debt; (sg only) duty	pr sg в долгу, nom pl долги
зима	winter	a sg зиму, g sg зимы, nom pl зимы
крепко	firmly
молча	in silence, without speaking
переход	crossing, transition
знакомиться/по- (с +inst)	to become acquainted with; meet	i знакомлюсь, знакомишься; p: познакомлюсь, познакомишься
портрет	portrait
чудо	marvel, miracle	nom pl чудеса, g pl чудес, d pl чудесам
бок	side	pr sg на боку, nom pl бока
вводить/ввести (+a)	to bring in, introduce	i ввожу, вводишь; p: введу, введёшь, past ввёл, ввела
держаться (i) (за +a)	to hold on (to); (+g) keep to	i: держусь, держишься
жалеть/по- (+a)	to pity, feel sorry for; (o +pr) regret	i жалею, жалеешь; p пожалею, пожалеешь
итак	so, so then	Итак, теперь всё ясно So now everything is clear
надеяться (i)	to hope	i: надеюсь, надеешься
настроение	mood
облако	cloud	nom pl облака, g pl облаков
одновременно	simultaneously
отходить/отойти (от +g)	to move away (from); depart (train)	i отхожу, отходишь; p: отойду, отойдёшь, past отошёл, отошла; отойти от окна to move away from the window
понятие	concept, notion
поток	stream, flow
рождаться/родиться	to be born	p: рожусь, родишься, past родился, родилась
стоимость (f)	cost, value	no pl
стремление	striving, aspiration, desire
территория	territory
висеть (i)	to hang, be hanging	i: вишу, висишь
вниз	down
горный	mountain (adj); mining
городской	urban, town (adj)
диван	divan, couch
заговаривать/заговорить	to start speaking
кстати	incidentally, by the way; opportunely
образец	model, pattern	g sg образца
принадлежать (i) (+d)	to belong to; (к +d) be a member of	i: принадлежу, принадлежишь
суд	court (of law); trial	g sg суда
автомобиль (m)	car
адрес	address	nom pl адреса
вверх	upwards
духовный	spiritual
иностранный	foreign
литературный	literary
напоминать/напомнить (+d о +pr)	to remind (s.o. of sth.)
осторожно	carefully, cautiously
побеждать/победить (+a)	to defeat, conquer	no 1st person sg, p: победишь
полезный	useful
расчёт	calculation
уверенный	confident, sure	short forms: уверен, уверена
болезнь (f)	illness
впереди	ahead
вскоре	soon	deck#2	due@2020-09-30 11:52:34
железо	iron
навстречу (+d)	towards
обладать (i) (+inst)	to possess	обладать хорошим умом to have a good brain
опасный	dangerous
полтора	one and a half	with f nouns полторы; g, d, inst, pr полутора; полтора года 1.5 years
считаться (i)	(+inst) to be considered; (c +inst) take into account	Он считается гением Не is considered a genius; С этим можно не считаться This can be ignored
трудовой	labour, work (adj)
участвовать (i) (в +pr)	to take part in	i: участвую, участвуешь
шея	neck
южный	southern
бросаться/броситься	to rush, throw oneself	p: брошусь, бросишься
всеобщий	general; universal
договор	agreement; treaty; contract
короткий	short
культурный	cultured, civilized; cultural
мягкий	soft; gentle
ой	o; oh (expressing surprise or fright)
развиваться/развиться	to develop	p разовьюсь, разовьёшься, past развился, развилась
тянуть/по- (+a)	to pull, drag	i тяну, тянешь
вечный	eternal
январь (m)	January	g sg января
обнаруживать/обнаружить (+a)	to reveal; discover
особенный	special, particular
подготовка (к +d)	preparation (for)	no pl
придумывать/придумать (+a)	to think up, invent
редакция	editorial office; editing
собственность (f)	property (something owned)	частная собственность private property; собственность на землю ownership of land
строго	strictly
убеждаться/убедиться (в +pr)	to convince oneself, become sure (of sth)	no 1st pers sg, p: убедишься
угроза	threat
уничтожать/уничтожить (+a)	to destroy; do away with
груз	load; cargo
здоровый	healthy
кольцо	ring (i.e. small hoop)	nom pl кольца, g pl колец, d pl кольцам
кончать/кончить (+a)	to finish; graduate
мешок	bag, sack	g sg мешка
мост	bridge	pr sg на мосту, nom pl мосты
смена	changing; shift (e.g in factory); replacement
снимок	photograph	g sg снимка
телега	cart
тип	type; (coll) bloke, fellow
торопиться/по-	to hurry, be in a hurry	i: тороплюсь, торопишься
физический	physical
весть (f)	piece of news	nom pl вести, g pl вестей
водка	vodka
говориться (i)	to be said	i: говорится; как говорится as they say
девять	nine	g, d, pr девяти, inst девятью
заканчивать/закончить (+a)	to finish
круглый	round
мораль (f)	morals, morality; moral (of a story)	no pl
немножко	(coll) a little, a bit
обида	offence, insult
обыкновенный	usual; ordinary
окончательно	finally, definitively
погодить (р)	to wait a little	p: погожу, погодишь; Погодите! Wait a moment!
по-моему	in my opinion; as I would have it
помощник	assistant
пьяный	drunk	short forms: пьян, пьяна, пьяно, пьяны
соединение	joining, combination; joint, join (tech)
толпа	crowd	nom pl толпы
ударять/ударить (+a)	to strike, hit	i: ударять/бить; i ударяю
хуже	worse
единый	single, sole; united
злой	evil, wicked; bad-tempered, fierce	short forms зол m, зла f
назначение	appointment (to a post); purpose (for which sth is intended)	назначение инструмента purpose of a tool; использовать что-нибудь по назначению to use sth for its proper purpose
осень (f)	autumn
пар	steam	pr sg в пару, nom pl пары
полевой	field (adj)
читать/прочесть (+a)	to read	i: Вы читали эту книгу?|Have you read this book? /p прочту, прочтёшь, past прочёл, прочла; p also прочитать
собственно	strictly, properly	собственно говоря strictly speaking
старинный	ancient
столовая (f) (adj)	dining-room; canteen, refectory
сухой	dry
готовить/при- (+a)	to prepare; to cook	i: готовлю, готовишь
держава	power (powerful country)	великие державы the Great Powers
заставлять/заставить (+a +inf)	to force, compel (s.o. to do sth)	i: заставляю, заставляешь; p: заставлю, заставишь; Он заставил нас выучить все слова Не forced us to learn all the words
колесо	wheel	nom pl колёса, g pl колёс
лететь/по-	to fly	i: лечу, летишь; det verb of motion; p: полечу, полетишь
нечто	something (=что-то)	only nom and а; нечто другое something else
полагать (i)	to suppose, think	no p
пропасть (f)	precipice, abyss	g pl пропастей
свежий	fresh
северный	north, northern
собирать/собрать (+a)	to gather, collect	p: соберу, соберёшь, past собрал, собрала, собрало
удивительный	surprising, astonishing
участник	participant
хозяйка	owner, proprietress; hostess	g pl хозяек
чей	whose	f чья, n чьё, pl чьи; Это чья книга? Whose book is this?
беспокоиться/о- (о +pr)	to worry, be worried (about)
во-первых	firstly, in the first place	deck#2	due@2020-09-30 11:47:59
выражение	expression
горе	grief, sorrow	no pl
детство	childhood
доллар	dollar
доля	portion, share; lot, fate	nom pl доли, g pl долей
итог	sum, total	подвести итоги to sum up
коридор	corridor
ныне	now; today (=теперь)
признавать/признать	to admit; to recognize	i признаю, признаёшь
среда	Wednesday; environment, milieu	g sg среды, nom pl среды, a sg среду, d pl средам
училище	college (vocational)
бомба	bomb
бюро (indecl)	office	(indecl)
высший	highest, supreme
дедушка (m)	grandfather	g pl дедушек
действительность (f)	reality; validity (of a document)	в действительности in reality, in actual fact
заседание	meeting, conference, session	на заседании at a meeting
ключ	key; spring, source	g sg ключа
кресло	armchair	g pl кресел
оставлять/оставить (+a)	to leave (sth), abandon	i: оставляю, оставляешь; p оставлю, оставишь
останавливать/остановить (+a)	to stop (sth)	p: остановлю, остановишь
отмечать/отметить (+a)	to mark, note, record, mention; to celebrate	p: отмечу, отметишь
погода	weather
поступать/поступить	to act; (в +a) enter (organization)	i: поступать в университет to enter а university; p поступлю, поступишь
режим	regime; rules, regulations; diet
решительно	resolutely; definitely, absolutely
сравнение	comparison	по сравнению с +inst compared with
странно	strangely; it is strange
строгий	strict, severe
стыдно	it is shameful; (+d of person X) X is ashamed	Как вам не стыдно? You ought to be ashamed
танец	dance	g sg танца
больно	painfully; it is painful
добро	good, good deeds; goods (coll)	Добро пожаловать! Welcome!	deck#4	due@2020-10-29 11:52:29
заключать/заключить (+a)	to conclude; enclose; imprison	p: заключу, заключишь
занавес	(heavy) curtain
когда-то	at some time, at one time	Я был там когда-то I was there once
кончаться/кончиться	to end, come to an end
миллиард	1,000,000,000 (American billion)
нынешний	present, present-day
обстоятельство	circumstance
ох	oh, ah (expressing regret, annoyance)
переходить/перейти (+a or через +a)	to cross, go over	i: перехожу, переходишь; p: перейду, перейдёшь, past перешёл, перешла
привыкать/привыкнуть (к +d)	to get used to; get into the habit of	p: привыкну, привыкнешь, past привык, привыкла
присылать/прислать (+a)	to send	p: пришлю, пришлёшь
противник	opponent, adversary
реальный	real; realistic
спичка	match, match stick	g pl спичек
творческий	creative
торговля	trade	внешняя торговля foreign trade; торговля оружием arms trade
установка	installation; purpose
воздушный	air (adj)
всюду	everywhere
журналист	journalist
захватывать/захватить (+a)	to take, grasp; seize	p: захвачу, захватишь
звание	title; calling
звонить/по- (+d)	to ring, telephone (s.o.)
конкретный	concrete, specific	конкретный пример specific example
кричать/крикнуть	to shout
март	March (month)
множество	large number
отправлять/отправить (+a)	to send off	i отправляю; p отправлю, отправишь
противоречие	contradiction
резкий	sharp
сомнение	doubt
темп	rate, speed
труба	pipe	nom pl трубы
тюрьма	prison	nom pl тюрьмы, g pl тюрем
внимательно	attentively
лишний	extra, spare
погибать/погибнуть	to perish	p: past погиб, погибла
порог	threshold
прибывать/прибыть	to arrive (formal); (coll) increase	p: прибуду, прибудешь, past прибыл, прибыла, прибыло
просьба	request
состояться (р)	to take place	p состоится; no i
творчество	creative work
университет	university
академик	academician
битва	battle
взрослый	adult
капля	drop	g pl капель
контроль (m)	checking
многое (n)	much
непонятный	incomprehensible
нижний	lower
осуществление	carrying out
прогресс	progress
пункт	point
редкий	rare
содержать (i)	to contain	i: содержит
уважение	respect
ужас	horror
цветной	coloured	цветной телевизор colour television
шар	sphere	nom pl шары; земной шар the globe
врать/со-	to tell lies; talk nonsense	i: вру, врёшь
дама	lady
демократия	democracy
деревянный	wooden
истина	truth
исчезать/исчезнуть	to vanish; disappear	p: past исчез, исчезла
каменный	stone (adj)
любимый	favourite
оттуда	from there
поведение	behaviour
вести/по- (+a)	to lead	i: Куда ведёт эта дорога? Я веду сына в парк|Where does this road lead? I am taking my son to the park; p: поведу, поведёшь, past повёл, повела
стоять/по-	to stand; p: to stand for a while	Он стоит за домом|He is standing behind the house; p: постою, постоишь
потребность (f)	need
рукав	sleeve	g sg рукава, nom pl рукава
соединённый	united	Соединённые Штаты Америки (США) United States of America
трудиться/по-	to labour	i: тружусь, трудишься
фамилия	surname
шуметь (i)	to make a noise	i: шумлю, шумишь
активный	active
библиотека	library
ездить/по-	to travel	i: езжу, ездишь; p: по-/съ-
лезть/по-	to climb	i: лезу, лезешь, past лез, лезла; p полезу, полезешь; past полез, полезла
образовывать/образовать (+a)	to form	p образую, образуешь
печка	stove	g pl печек
планета	planet
понятный	comprehensible
правило	rule
прозрачный	transparent
торговый	trade (adj)
шинель (f)	greatcoat	due@2020-09-29 11:57:29
шутить/по-	to joke	i: шучу, шутишь
шутка	joke	g pl шуток
ящик	box, crate
авторитет	authority
болеть (i)	to be ill; to hurt
вечерний	evening (adj)
видный	eminent
внезапно	suddenly
гулять/по-	to take a walk; (coll) take time off	i: гуляю, гуляешь; p погуляю
двенадцать	twelve
зверь (m)	wild animal	g pl зверей
звук	sound
звучать/про-	to sound	i: звучит; Это звучит странно That sounds strange
командовать (i) (+inst)	to command (sth)	i командую, командуешь	deck#2	due@2020-09-30 11:54:11
курить/по-	to smoke	i: курю, куришь; p: по-/за-
непременно	without fail	Он непременно придёт He’ll definitely come
низко	low
образовываться/образоваться	to be formed	p: образуется
означать (i)	to mean
острый	sharp
питание	feeding, food
полоса	strip	nom pl полосы, g pl полос, d pl полосам
святой	sacred; saint	собор святого Павла St. Paul’s Cathedral
середина	middle
случайно	by chance
сутки (f) (pl)	24 hours	g pl суток; трое суток three days and nights
убегать/убежать	to run away	p: убегу, убежишь, убегут
шапка	hat (without brim)	g pl шапок
агрессия	aggression
благодаря (+d)	thanks to
зло	evil	no pl except in меньшее из двух зол lesser of two evils
кругом	around
крыльцо	entrance steps; porch	nom pl крыльца, g pl крылец, d pl крыльцам
нередко	often
обед	meal; dinner
поддержка	support
подъём	rise
причём	and furthermore
проект	project
сообщение	communication
сосед	neighbour	nom pl соседи, g pl соседей
сущность (f)	essence	в сущности in essence
твёрдо	firmly
цифра	figure, number
англичанин	Englishman	nom pl англичане, g pl англичан
во-вторых	secondly
вооружение	arming; arms
восток	east	на востоке in the east
запах	smell
зимний	winter (adj)
карандаш	pencil	g sg карандаша
корова	cow
корпус	corps; building; body, frame	(nom pl корпуса) corps; building; (nom pl корпусы) body, frame
краска	paint	g pl красок
май	May	deck#3	due@2020-10-06 11:47:11
передача	transmission
ходить/по-	to walk about	p: похожу, походишь
походить (i) (на +a)	to resemble	no p
пояс	belt, waist	nom pl пояса
указывать/указать (+a or на +a)	to point out	p: укажу, укажешь
вряд ли	(it’s) unlikely	Вряд ли он придёт He’s unlikely to come
горизонт	horizon
жаль	it’s a pity	Очень жаль, что вас не было What a pity you weren’t there
житель (m)	inhabitant
задумываться/задуматься (о +pr/над +inst)	to think deeply, become thoughtful (about)
изменять/изменить (+a)	to change, alter; (+d) betray	i изменяю; p: изменю, изменишь	deck#2	due@2020-09-30 11:49:22
минутка	moment	g pl минуток; Одну минутку Just a moment	deck#4	due@2020-10-29 11:57:15
некогда	there’s no time; once	Мне некогда I haven’t time; Некогда здесь было озеро There was once a lake here
ответственность (f)	responsibility
передняя	entrance hall
пост	post (job)	pr sg на посту, nom pl посты
расстояние	distance	на расстоянии трёх километров three kilometres away
сведение	information, reduction	often pl; У меня нет сведений об этом I have no information about that
север	north	на севере in the north
сердиться/рас- (на +a)	to be angry (with)	i: сержусь, сердишься; p рассержусь, рассердишься	deck#2	due@2020-09-30 11:54:00
совесть (f)	conscience
традиция	tradition
фраза	phrase
чемодан	suitcase
голый	naked
защищать/защитить (+a)	to defend	p защищу, защитишь
кафедра	department (university)	на кафедре русского языка in the Russian department
компания	company; group of friends
оборудование	equipment
покой	peace, quiet
почему-то	for some reason
смелый	brave, bold
спорить/по-	to argue
спорт	sport	no pl; виды спорта sports
успешно	successfully
фильм	film
безопасность (f)	security
выпускать/выпустить (+a)	to release	p: выпущу, выпустишь
дисциплина	discipline
дышать/по- (+inst)	to breathe	i: дышу, дышишь; дышать свежим воздухом to breathe fresh air
здорово	(coll) splendid(ly), great healthily; (coll) hi!
изображение	depiction
класть/положить (+a)	to put	i: кладу, кладёшь, past клал, клала; p: положу, положишь
крепость (f)	fortress; strength
несомненно	undoubtedly
окружать/окружить (+a +inst)	to surround (sth with sth)
опускать/опустить (+a)	to lower, drop	p: опущу, опустишь
отлично	excellent(ly)
примерно	approximately	deck#2	due@2020-09-30 11:56:09
спустя (+a)	later (= через)	спустя три дня three days later
строительный	construction (adj)	строительная площадка building site
талант	talent
уставать/устать	to tire	i устаю, устаёшь; p устану, устанешь
юность (f)	youth
браться/взяться (за +a)	to take hold of; start work on; to take up, get down to	i: берусь; берёшься, past брался, бралась; p: возьмусь, возьмёшься, past взялся, взялась
величина	size	nom pl величины
возвращать/вернуть (+a)	to return
зеркало	mirror	nom pl зеркала, g pl зеркал, d pl зеркалам
крыло	wing	nom pl крылья, g pl крыльев
лестница	staircase; ladder
определять/определить (+a)	to define, determine	i: определяю, определяешь
очередной	next; regular
пальто (n) (indecl)	overcoat
папироса	cigarette
платье	dress	g pl платьев
разбираться/разобраться (в +pr)	to sort sth out; investigate; understand	p: разберусь, разберёшься, past разобрался, разобралась
пушка	cannon	g pl пушек
получение	receiving
приятно	pleasant
посёлок	settlement	due@2020-09-29 11:57:07
потеря	loss
пожар	fire
сердито	angrily
слух	hearing; rumour
снаряд	shell (mil)
сообщать/сообщить (+a +d)	to communicate (sth to s.o.)
тесный	tight
экзамен	examination	экзамен по русскому языку Russian exam
благо	good (thing), benefit; (coll) since, seeing that
болото	marsh
внутри (+g)	inside
выглядеть (i)	to look	i выгляжу, выглядишь; Она выглядит хорошо She looks well
готовиться (i) (к +d)	to prepare (for sth)	i готовлюсь, готовишься
двигатель (m)	motor, engine
добавлять/добавить (+a к +d)	to add (sth to sth)	i добавляю; p добавлю, добавишь
дрожать/за-	to shiver, start shaking	i: дрожу, дрожишь
капиталист	capitalist
крепкий	strong
музыкальный	musical
нехорошо	not good
объявлять/объявить (+a or о +pr)	to declare, announce	i объявляю; p объявлю, объявишь
организм	organism
остаток	remainder
подобно (+d)	similar (to)
покрывать/покрыть (+a +inst)	to cover (sth with sth)	p: покрою, покроешь	deck#2	due@2020-09-30 11:54:26
поп	priest (coll)	g sg попа
по-прежнему	as before
привычка	habit	g pl привычек
соглашение	agreement
спор	argument
строка	line (of text)	nom pl строки, d pl строкам
тянуться/по-	to stretch; stretch os	i тянется; p потянусь, потянешься
увеличение	increase
ужасно	terribly
урожай	harvest
ценный	valuable
чисто	purely, cleanly
бегать/по-	to run around
бегать/с-	to run there and back, run somewhere (and return)
борода	beard	a sg бороду, nom pl бороды, g pl бород, d pl бородам
депутат	elected representative
заявление	announcement; application
коротко	short, briefly	коротко говоря in short
напрасно	in vain
ночью	at night
охота	desire; hunting	охота на лис fox hunting
пища	food
помещение	accommodation, premises
ровно	evenly; precisely	ровно в десять at ten o’clock precisely
тайга	taiga (northern forest)	deck#3	due@2020-10-06 11:48:22
телеграмма	telegram
толстый	fat (adj)
транспорт	transport
бык	bull	g sg быка
выдерживать/выдержать (+a)	to withstand	p: выдержу, выдержишь
достигать/достигнуть (+g)	to achieve, reach	p: достигнуть or достичь; past достиг, достигла
вынимать/вынуть (+a)	to take out
выполнение	carrying out
кожа	skin; leather
меньший	smaller
мол	he/she/they said	Она, мол, не знает She said she doesn’t know
настолько	so much
неожиданный	unexpected
официальный	official
охотник	hunter
пламя (n)	flame	g sg пламени, no pl
понимание	understanding
протягивать/протянуть (+a)	to stretch out	p: протяну, протянешь
профессия	profession
сооружение	construction
спешить/по-	to hurry
сторож	watchman	nom pl сторожа
ступать/ступить	to step	p ступлю, ступишь
тревога	alarm
утверждать (i)	to affirm, maintain
белоснежный	snow-white
бутылка	bottle	g pl бутылок	deck#3	due@2020-10-06 11:56:48
волноваться/вз-	to worry	i: волнуюсь, волнуешься; Не волнуйтесь Don’t worry; p: вз-/за-
давление	pressure
запад	west	на западе in the west
колебание	hesitation
кровать (f)	bed
механический	mechanical
мощность (f)	power (of engine etc.)
направлять/направить (+a)	to direct	i направляю; p: направлю, направишь
подарок	present, gift
подлинный	genuine	deck#2	due@2020-09-30 11:48:20
поскольку	since, because, in as far as
превращение	conversion
профсоюз	trade union
разбивать/разбить (+a)	to break, smash	p разобью, разобьёшь
сметь/по- (+inf)	to dare	i: смею, смеешь
ствол	trunk (tree); barrel (gun)	g sg ствола
уверенность (f)	confidence
фонарь (m)	lamp	g sg фонаря
верховный	supreme	deck#2	due@2020-09-30 11:56:14
взаимный	mutual
градус	degree (°)	сорок градусов мороза forty degrees below zero
допускать/допустить (+a к +d)	to admit (s.o. to); assume; allow	p: допущу, допустишь
заказ	order (for sth)
инициатива	initiative
лекция	lecture
мокрый	wet
моральный	moral
опытный	experienced
отдел	section, department
отдых	rest; holiday
отсутствие	absence	deck#2	due@2020-09-30 11:57:12
призыв	call, appeal; call-up
производительность (f)	productivity
пятнадцать	fifteen
реакция	reaction
сказка	fairy-tale	g pl сказок
сходить/сойти (с +g)	to go down (from)	i схожу, сходишь; p: сойду, сойдёшь, past сошёл, сошла; сойти с ума to go mad
старушка	old woman	g pl старушек
чудесный	wonderful
батарея	battery; radiator
бурный	stormy
велеть (i/p) (+d +inf)	to order (s.o. to do sth)	велю, велишь; p also по-
главное (n) (adj)	the main thing
гнать/по- (+a)	to drive; hunt, persecute, chase	гоню, гонишь, past гнал, гнала, гнало
догадываться/догадаться	to guess; (+inf) have the sense to
завоёвывать/завоевать (+a)	to conquer	p: завоюю, завоюешь
изба	peasant cottage	nom pl избы
инструмент	instrument; tool
купец	merchant
лёд	ice	g sg льда, pr sg на льду
мороз	frost
новость (f)	piece of news	g pl новостей
оборона	defence
освобождение	liberation
пахнуть (i) (+inst)	to smell (of)	i: пахнет
повесть (f)	story, novella	g pl повестей
подвиг	feat, heroic deed
прощаться/по- (с +inst)	to say goodbye (to)
свыше	from above; (+g) more than
торчать (i)	to stick out	i торчу, торчишь
выражать/выразить (+a)	to express	p выражу, выразишь
жизненный	vital; life (adj)
знак	sign
кран	tap; crane
крестьянский	peasant (adj)
личность (f)	personality; individual
масштаб	scale
мероприятие	measure; function (reception etc.)
охрана	protection; guard
посвящать/посвятить (+a +d)	to devote, dedicate (sth to sth/s.o.)	i посвящу, посвятишь
присутствие	presence
пустяк	trifle	g sg пустяка	due@2020-09-29 11:53:52
пятно	spot	nom pl пятна, g pl пятен
располагать/расположить (+a)	to arrange, set out; ; win over; (+inst) to have available	i Мы располагаем большими деньгами We have plenty of money available; p расположу, расположишь
рождение	birth
сопротивление	resistance
угодно	to your liking	как вам угодно as you wish; когда вам угодно whenever you like
ужасный	terrible
флаг	flag
царский	tsar’s; tsarist
частность (f)	detail	в частности in particular
апрель (m)	April
атака	attack
двое	two	двое детей two children
девчонка	girl (coll)	g pl девчонок
достоинство	merit, virtue; dignity; value
европейский	European	Европейский Союз European Union
ежели	if (obs or coll)
крестьянство	peasantry
медаль (f)	medal
менять/по- (+a)	to change	меняю, меняешь
насчёт (+g)	about, concerning
ничтожный	worthless
норма	norm
нужда	want, need	nom pl нужды
отделение	department, section
отчего	why	deck#2	due@2020-09-30 11:57:02
патриот	patriot
побывать (р) (в +pr)	to visit (a place)
подписывать/подписать (+a)	to sign	p подпишу, подпишешь
посуда	crockery, dishes
прекрасно	fine, excellent(ly)
пропаганда	propaganda
пулемёт	machine-gun
районный	regional, district (adj)
соревнование	competition
грубый	coarse, rude
участок	plot of land; district	избирательный участок electoral district
бригада	brigade, team	бригада рабочих team of workers
коллектив	group, team
командир	commander	командиры армии army commanders
биться (i)	to fight; to beat	i бьюсь, бьёшься
гибель (f)	ruin, destruction
густой	thick, dense
единство	unity
зритель (m)	spectator
зря	for nothing, pointlessly (coll)	зря деньги тратить to waste money
исходить (i) (из +g)	to issue from, proceed from	i исхожу, исходишь
молодость (f)	youth	deck#3	due@2020-10-06 11:53:14
нищий	destitute; beggar
отправляться/отправиться	to set off	i отправляюсь; p отправлюсь, отправишься
чувствовать/по- (+a)	to feel	i: чувствую, чувствуешь; p почувствую
президиум	presidium
признак	sign, indication	признаки жизни signs of life
дикий	wild
распоряжение	instruction, command
светиться (i)	to shine, gleam	i светится
сеть (f)	net; network	g pl сетей
спасать/спасти (+a)	to save	p спасу, спасёшь, past спас, спасла
сумма	sum
социализм	socialism
заключаться (i) (в +pr)	to consist of	Дело заключается в следующем The matter is as follows
мальчишка (m)	boy, small boy (coll)	g pl мальчишек
докладывать/доложить (о +pr)	to report (on)	p доложу, доложишь
еле	barely, only just
женский	female
заниматься/заняться (+inst)	to take up	p займусь, займёшься, past занялся, занялась
изменяться/измениться	to change	i изменяюсь; p изменюсь, изменишься; Всё изменилось Everything has changed
искусственный	artificial
конференция	conference	на конференции at a conference
куст	bush	g sg куста
мозг	brain	pr sg в мозгу, nom pl мозги
нация	nation	deck#4	due@2020-10-29 11:48:41
непрерывный	uninterrupted
обнимать/обнять (+a)	to embrace	p обниму, обнимешь, past обнял, обняла, обняло
превращаться/превратиться (в +a)	to turn into (sth)	p превращусь, превратишься
самовар	samovar
сверху	from above
шёпот	whisper	шёпотом in a whisper
абсолютный	absolute
борец	fighter; wrestler
выигрыш	win
горячо	hot(ly)
жестокий	cruel
заместитель (m)	deputy, substitute	заместитель директора deputy director
клетка	cage; cell (biol)	g pl клеток
неизвестно	(it is) unknown	Неизвестно, кто её отец No-one knows who her father is
неизвестный	unknown
обязанность (f)	duty, obligation
пустыня	desert
путешествие	journey, voyage
рассчитывать/рассчитать (на +a/+inf)	to calculate; expect; rely on	не рассчитать to miscalculate, misjudge
ремонт	repair; redecoration	due@2020-09-29 11:57:00
слева	on the left
суровый	harsh
таков	such [pronoun]	f такова, n таково, pl таковы; Такова жизнь Such is life
ус	whisker	усы moustache
фашистский	Fascist (adj)
частный	private, individual (adj)
чемпион	champion
ага	ah (yes), aha
арестовывать/арестовать (+a)	to arrest	p арестую
беречь (i) (+a)	to look after	i берегу, бережёшь, берегут, past берёг, берегла
билет	ticket
везде	everywhere
великолепный	magnificent
возбуждение	excitement, arousal
вступать/вступить (в +a)	to enter, join (organization)	p вступлю, вступишь; вступить в политическую партию to join a political party
выпуск	output; issue	deck#2	due@2020-09-30 11:48:54
грех	sin	g sg греха
грязный	dirty
дочка	daughter (intimate form)	g pl дочек
изготовление	manufacture
исключительно	exclusively; exceptionally
кое-что	something, a thing or two	Я хочу вам кое-что сказать I want to tell you something
критика	criticism
надпись (f)	inscription	deck#2	due@2020-09-30 11:55:35
обращение (к +d)	appeal (to); (c +inst) treatment; circulation
оттого	for that reason	оттого что because
плавать/по-	to swim; sail	p: сплавать to swim there and back
поездка	journey, trip	g pl поездок
пожилой	elderly
полиция	police
прочный	firm, solid
ружьё	gun, rifle	nom pl ружья, g pl ружей
рыжий	red-haired
сахар	sugar
служащий (m) (adj)	office worker, white-collar worker
справа	on the right
туча	storm cloud
устройство	organization; mechanism
утром	in the morning
благородный	noble
буря	storm, gale
вино	wine	nom pl вина
возникать/возникнуть	to arise	p past возник, возникла
вытаскивать/вытащить (+a из +g)	to drag out, pull out (from)
гигантский	giant (adj)
жаловаться/по- (на +a)	to complain (about)	i жалуюсь, жалуешься
заменять/заменить (+a +inst)	to replace (sth with sth)	i заменяю; p заменю, заменишь
лично	personally
молодец	fine fellow; well done!	Молодцы, ребята! Well done, lads!
навсегда	for ever
надевать/надеть (+a)	to put on (clothing etc.)	p надену, наденешь
объяснять/объяснить (+a)	to explain	i объясняю
поворачивать/повернуть (+a)	to turn
производить/произвести (+a)	to produce	i: произвожу, производишь; p произведу, произведёшь, past произвёл, произвела
стучать/по- (в +a)	to knock (at)	i стучу, стучишь
экспедиция	expedition
батюшка (m)	father
вооружённый	armed
выстрел	shot
гарантировать (i/p) (+a)	to guarantee	гарантирую
жертва	victim
живо	quickly; vividly
животное	animal
знамя (n)	banner	g sg знамени; nom pl знамёна
информация	information
концерт	concert	на концерте at a concert
костёр	bonfire	g sg костра
крайне	extremely
механизм	mechanism
многочисленный	numerous
насколько	how much; as much	насколько мне известно as far as I know
объективный	objective (adj)
объяснение	explanation
переворот	coup
перо	feather	nom pl перья
поворот	turn
позади	behind
приобретать/приобрести (+a)	to acquire (formal)	p приобрету, приобретёшь, past приобрёл, приобрела
прислушиваться/прислушаться (к +d)	to listen carefully (to)
распределение	distribution
родитель (m)	parent
свеча	candle	nom pl свечи, g pl свечей
своеобразный	distinctive, individual
секрет	secret
склад	warehouse, store	на складе in the warehouse
скучно	boring
согласный	in agreement; (as noun) consonant	short forms: согласен, согласна, согласно, согласны; Вы согласны? Do you agree?
сомневаться/усомниться (в +pr)	to doubt
сочинение	composition, essay
список	list
способствовать (i) (+d)	to promote, further (sth)	i способствую
справляться/справиться (с +inst)	to cope (with); (o +pr) ask about	p справлюсь, справишься
сфера	sphere
танцевать/по-	to dance	i танцую, танцуешь
тащить/по- (+a)	to drag	i тащу, тащишь
успокаиваться/успокоиться	to calm down
этап	stage, phase
явно	clearly, obviously
актёр	actor
арест	arrest
беседовать/по- (с +inst)	to talk, converse (with); have a talk (with)	i беседую, беседуешь
бытие	existence
весенний	spring (adj)	deck#2	due@2020-09-30 11:54:31
вкус	taste
воспоминание	memory, recollection
выдавать/выдать (+a)	to give out, issue; betray; give away	i выдаю, выдаёшь; p выдам, выдашь, выдаст, выдадим, выдадите, выдадут
выдающийся	eminent, prominent [participle used as (adj)]	выдающиеся учёные eminent scholars
гудеть (i)	to hum; hoot	i гужу, гудишь
добыча	booty; mining
дорожка	path; track	g pl дорожек
доставлять/доставить (+a)	to deliver	i доставляю; p доставлю, доставишь
достаточный	sufficient
крест	cross	g sg креста
медицинский	medical
механик	mechanic
му́ка	torment
мука́	flour
напряжение	tension
нормальный	normal
ноябрь (m)	November	g sg ноября
печальный	sad
привозить/привезти (+a)	to bring (by transport)	i привожу, привозишь; p привезу, привезёшь, past привёз, привезла
признание	confession, admission
прятать/с- (+a)	to hide (sth)	i прячу, прячешь; p спрячу, спрячешь
рассвет	daybreak
сегодняшний	today’s	сегодняшняя газета today’s paper
существенный	essential; important
уважать (i) (+a)	to respect
фирма	firm, company
автомат	slot-machine; phone box
буква	letter (of alphabet)
глупость (f)	foolishness	глупости nonsense
голод	hunger
греческий	Greek (adj)
деловой	business (adj)	деловые люди businesspeople
доверие	trust
драгоценный	valuable
душевный	mental; sincere, heartfelt
заглядывать/заглянуть	to glance	p загляну, заглянешь
кой	which (coll)	ни в коем случае certainly not
матч	match (game)
наблюдение	observation
открываться/открыться	to open	p откроется; Музей откроется в десять The museum will open at ten
отличие	difference; distinction	в отличие от +g as distinct from
перестройка	restructuring	g pl перестроек
преимущество	advantage
приятный	pleasant
раскрывать/раскрыть (+a)	to open wide; reveal	p раскрою, раскроешь
редко	rarely
соответствовать (i) (+d)	to correspond (to)	i соответствует
соответствующий	corresponding
сталь (f)	steel
хвост	tail	g sg хвоста
чрезвычайно	extremely
агрессивный	aggressive
вокзал	(main) station	на вокзале at the station
глухой	deaf; indistinct, muffled; remote (of place)
доводить/довести (до +g)	to lead to, take as far as	i довожу, доводишь; p доведу, доведёшь, past довёл, довела
естественно	naturally
любопытство	curiosity
непосредственно	immediately
нигде	nowhere
обращать/обратить (+a)	to turn	i обращать внимание на +а to note, take note of; p: обращу, обратишь; обратить внимание на +а to note sth
обширный	extensive, vast
ответственный	responsible
отличный	excellent
парк	park; depot
платить/за- (+d за +a)	to pay (s.o. for sth)	i плачу, платишь
сажать/посадить (+a)	to plant, seat	p посажу, посадишь
предстоять (i) (+d)	to lie ahead (of s.o.)	i предстоит; Ему предстоят трудности Не faces difficulties
простор	space, expanse
профсоюзный	trade union (adj)
решительный	decisive
решаться/решиться (на +a or +inf)	to make up one's mind (to); to bring os (to); dare, risk; be decided
рынок	market	на рынке in the market
сплошной	continuous
столб	pole, pillar	g sg столба
точность (f)	precision; punctuality
трое	three, threesome	трое детей three children
удивительно	surprisingly
шестьдесят	sixty
арена	arena
взор	look, glance
вносить/внести (+a в +a)	to carry in, bring in	i вношу, вносишь; p внесу, внесёшь, past внёс, внесла
вследствие (+g)	because of, owing to
грозить/при- (+d)	to threaten (s.o.)	i грожу, грозишь; p: при-/по-
далее	further	и так далее (и т.д.) and so on, etc
довольный (+inst)	satisfied, pleased (with)	short forms: m доволен, f довольна, pl довольны; Я довольна ими I’m pleased with them
зависимость (f)	dependence	в зависимости от +g depending on
кто-нибудь	anyone	Вы видели кого-нибудь? Did you see anyone?
листок	small sheet (of paper); small leaf, leaflet
одетый (в +a)	dressed; wearing
оказывать/оказать (+a)	to render, give	i оказывать помощь to give assistance; p окажу, окажешь; оказать влияние на +a to exert an influence on
подруга	(female) friend
подушка	pillow; cushion	g pl подушек
правление	government; board (of management)	система правления system of government
расходиться/разойтись	to disperse, split up	i расходимся, past разошлись; p разойдёмся, past разошлись
рубашка	shirt	g pl рубашек
скала	crag, rock face, cliff	nom pl скалы
сперва	at first (coll)
справедливость (f)	justice, fairness
терпеть/по- (+a)	to be patient; endure	i терплю, терпишь
тьма	darkness
управлять (i) (+inst)	to manage, control	i управляю
февраль (m)	February	g sg февраля
характерный	characteristic (adj)
хм (or гм)	hm! (expressing hesitation)	(or гм)
артист	artiste, performer
благоприятный	favourable
выбирать/выбрать (+a)	to choose	p выберу, выберешь
декабрь (m)	December	g sg декабря
дивизия	division (army)
домашний	domestic	deck#3	due@2020-10-06 11:53:04
дыхание	breathing
заря	dawn; sunset	nom pl зори, g pl зорь, d pl зорям	deck#2	due@2020-09-30 11:48:33
колокол	bell	nom pl колокола
крутой	steep; severe
медный	copper (adj)
меняться/об-	to change; p: (+inst) exchange	i меняюсь; Всё меняется Everything is changing; p: об-/по-
невидимый	invisible
обязательство	pledge
оглядываться/оглядеться	to look round
оглядываться/оглянуться	to look back	p оглянусь, оглянешься
орден	medal, decoration; order (society)	(nom pl ордена) medal, decoration; (nom pl ордены) order (society)
отпускать/отпустить (+a)	to let go, release	p отпущу, отпустишь
очки (pl)	glasses, spectacles	g pl очков
переводить/перевести (+a)	to take across; transfer; translate	i перевожу, переводишь; p переведу, переведёшь, past перевёл, перевела
перспектива	perspective; prospect
применять/применить (+a)	to use, employ, apply	i применяю; p применю, применишь
присаживаться/присесть	to take a seat, sit down	p присяду, присядешь, past присел, присела
проверять/проверить (+a)	to check	i проверяю
сборник	collection (book of poems, stories, articles)
смешной	funny, ridiculous
спектакль (m)	(theatre) performance
справедливый	fair, just
сравнительно	comparatively
теоретический	theoretical
убирать/убрать (+a)	to take away; tidy; p: tidy up	p уберу, уберёшь, past убрал, убрала, убрало
ценность (f)	value
агроном	agronomist
внедрение	inculcation; putting into practice
восточный	eastern
годиться (i) (на +a/для +g)	to be fit (for), be usable	i гожусь, годишься
гордость (f)	pride
жениться (i/p) (на +pr)	to marry (of man)	женюсь, женишься
заметно	noticeably
кино (indecl)	cinema	(indecl)
коренной	fundamental
масло	butter; oil
мастерская	workshop, studio
мясо	meat
надёжный	reliable
назначать/назначить (+a +inst)	to appoint (s.o. as sth); fix, arrange
наступление	offensive, advance
невеста	bride; fiancee
обратный	reverse (adj)	обратный адрес sender’s address; в обратную сторону in the opposite direction
одинаковый	identical
относительно	relatively; (+g) concerning
памятник	monument
перебивать/перебить (+a)	to interrupt	p перебью, перебьёшь
дарить/по- (+a +d)	to give, present (sth to s.o.)
подход	approach
помещик	landowner
появление	appearance
прибыль (f)	profit	(f)
семейный	family (adj)
слыхать (i) (о +pr)	to hear (about) (coll)	no pres
слышаться/по-	to be heard	i слышится
сочинять/сочинить (+a)	to compose, make up	i сочиняю
талантливый	talented
технология	technology
тихонько	quietly (coll)
ткань (f)	cloth	(f)
толк	sense, point; understanding	с толком sensibly
тоска	melancholy, depression, ennui; (по +d) yearning (for)
фактор	factor
хохотать/за-	to guffaw, laugh loudly	i хохочу, хохочешь
агент	agent
бассейн	pool, swimming-pool; basin (geog)
вариант	variant
вне (+g)	outside
выбор	choice
гул	rumble	deck#2	due@2020-09-30 11:47:23
забор	fence
задний	rear (adj)
континент	continent
копейка	kopeck	g pl копеек
лозунг	slogan
невольно	unintentionally
нежный	tender, gentle
незаметно	imperceptibly
несчастный	unhappy
нефть (f)	oil, petroleum
отнимать/отнять (+a)	to take away	p отниму, отнимешь, past отнял, отняла, отняло	deck#2	due@2020-09-30 11:56:21
отступать/отступить (от +g)	to retreat; deviate (from)	p отступлю, отступишь
пассажир	passenger
подводный	underwater (adj)	deck#3	due@2020-10-06 11:46:52
прекращение	stopping, ending
провожать/проводить (+a)	to accompany, see off
раб	slave	g sg раба
роза	rose
ручка	small hand; handle; pen	g pl ручек
сигнал	signal
скрывать/скрыть (+a)	to hide, conceal	p скрою, скроешь
совершать/совершить (+a)	to accomplish, complete
столик	small table, restaurant table
стук	knock
торговать (i) (+inst)	to trade (in)	i торгую
торжественный	ceremonial; celebratory
фантастический	fantastic
ярко	brightly
бесконечно	endlessly	deck#2	due@2020-09-30 11:55:46
буквально	literally
выгодный	advantageous
генеральный	general (adj)
грандиозный	grandiose
грязь (f)	mud; dirt	pr sg в грязи
добираться/добраться (до +g)	to reach, get to	p доберусь, доберёшься, past добрался, добралась
должность (f)	post, job	g pl должностей
пугаться/ис- (+g)	to take fright (at)
июль (m)	July
койка	bunk, berth	g pl коек
костюм	suit; costume
ласково	affectionately
локоть (m)	elbow	g pl локтей
любопытный	curious
надоедать/надоесть (+d)	to bore	p надоем, надоешь (like есть), past надоел, надоела; Он ей надоел She’s bored with him
начальство	the management, the authorities
нуждаться (i) (в +pr)	to need, be in need of
одежда	clothes	deck#2	due@2020-09-30 11:57:22
окошко	small window	g pl окошек	due@2020-09-29 11:53:54
особо	specially; separately
отъезд	departure
практически	practically
прекращать/прекратить (+a)	to stop, discontinue	p прекращу, прекратишь
прогрессивный	progressive
продолжаться (i)	to continue	Работа продолжалось The work continued
произносить/произнести (+a)	to pronounce	i произношу, произносишь/p произнесу, произнесёшь, past произнёс, произнесла
разрабатывать/разработать (+a)	to work out, devise, develop, design, cultivate
разум	reason, intellect
розовый	pink; rosy
славный	glorious
смешно	comical(ly)
фото (indecl)	photo	(indecl)
шляпа	hat (with brim)
штука	thing (coll)
автоматический	automatic
активно	actively
вбегать/вбежать (в +a)	to run in	p вбегу, вбежишь, вбегут
везти/по- (+a)	to transport; (+d) be lucky	i везу, везёшь, past вёз, везла/p повезу, повезёшь, past повёз, повезла; Нам повезло We were lucky
ветвь (f)	branch	g pl ветвей
вредный	harmful
вскакивать/вскочить	to jump in; leap up	p вскочу, вскочишь
выводить/вывести (из +g)	to lead out; remove	i вывожу, выводишь; p выведу, выведешь, past вывел, вывела
грохот	crash; rumble
десятилетие	decade	deck#2	due@2020-09-30 11:48:29
достойный	worthy
дурной	bad, evil
жест	gesture
занятый	occupied, busy	short forms занят, занята, занято, заняты; Он занят He’s busy
записывать/записать (+a)	to note down	p запишу, запишешь
исключение	exception
ледяной	icy
лента	ribbon, tape
махать/махнуть (+inst)	to wave
муха	fly
негромко	quietly, in a low voice
непосредственный	immediate, direct, spontaneous
обижаться/обидеться	to take offence
обязанный	obliged	Она обязана прийти She must come
октябрьский	October (adj)
орать (i)	to howl, yell	i ору, орёшь
оценивать/оценить (+a)	to evaluate, appreciate	p оценю, оценишь
племя (n)	tribe	g sg племени, nom pl племена
поглощать/поглотить (+a)	to swallow, absorb	p поглощу, поглотишь
подготавливать/подготовить (+a)	to prepare	p подготовлю, подготовишь
подробно	in detail
потолок	ceiling
проводиться (i)	to be conducted, take place	i проводится
проклятый	damned
разрыв	break, gap; shell-burst
распространение	spreading, dissemination
самостоятельный	independent
складываться/сложиться	to take shape; club together	p сложусь, сложишься
союзник	ally
страсть (f)	passion	g pl страстей
танк	tank (mil)
тарелка	plate	g pl тарелок
топливо	fuel
триста	three hundred	g трёхсот
убеждать/убедить (+a)	to convince; persuade	no 1st pers sg, p убедишь
удивление	surprise
удобный	comfortable; convenient
холм	hill	g sg холма
четверть (f)	quarter
безусловно	undoubtedly
больница	hospital
восторг	delight
выносить/вынести (+a)	to carry out, take away; endure	i выношу, выносишь; p вынесу, вынесешь, past вынес, вынесла
выскакивать/выскочить (из +g)	to jump out (of)
горло	throat
действительный	real, actual; valid
доход	income
думаться (i)	to be thought	мне думается I think
заключение	conclusion; confinement	в заключение in conclusion
издание	publication; edition
изучать/изучить (+a)	to learn, master	p изучу, изучишь
конечный	final
корзина	basket
кормить/на- (+a)	to feed	i кормлю, кормишь; на- p/по- р
лишать/лишить (+a +g)	to deprive (s.o. of sth)
мужской	masculine; male
непрерывно	continuously
обсуждение	discussion
одевать/одеть (+a)	to dress (s.o.); (coll) put on	p одену, оденешь
палка	stick	g pl палок
перемена	change
площадка	ground, area	g pl площадок; датская площадка children’s playground
победитель (m)	victor
подтверждать/подтвердить (+a)	to confirm	p подтвержу, подтвердишь
портфель (m)	briefcase
приятель (m)	friend
прочь	away
разрешение	permission; solution
священник	priest	deck#2	due@2020-09-30 11:55:50
сентябрь (m)	September	g sg сентября
совершенный	perfect
совать/сунуть (+a)	to thrust, poke (sth into sth)	i сую, суёшь; p суну, сунешь
тыл	rear (military)	pr sg в тылу
увеличивать/увеличить (+a)	to increase (sth)
ура	hurrah, hurray	due@2020-09-29 11:47:45
фантазия	imagination
чего	why (coll)
бумажка	piece of paper; banknote	g pl бумажек
вал	billow; rampart; gross output (econ)	nom pl валы
вина	guilt
волнение	agitation; disturbance
воскресенье	Sunday
впоследствии	subsequently
выяснять/выяснить (+a)	to clarify, establish
глянуть (р) (на +a)	to glance (at)
гостиница	hotel
двигаться/двинуться	to move
должно	one ought to
должно быть	probably
драться/по-	to fight; have a fight with	i дерусь, дерёшься, past дрался, дралась
запоминать/запомнить (+a)	to commit to memory, memorize
звено	link	nom pl звенья
издательство	publishing house
интеллигенция	intelligentsia; professional people
командование	command
крепостной	serf
логика	logic
насилие	violence, force
наступать/наступить	to advance; begin; tread on; come (of time, seasons)	p наступлю, наступишь; Наступило лето Summer came
небесный	heavenly, celestial
независимый	independent
огон(ё)к	light	g sg огонька
освобождать/освободить (+a)	to liberate, free	p освобожу, освободишь
отпуск	leave (from work)	Директор в отпуске The director is on holiday
переговоры (m) (pl)	negotiations	g pl переговоров
пиджак	jacket	g sg пиджака
плотный	compact; solid	плотный обед filling meal
поддерживать/поддержать (+a)	to support	p поддержу, поддержишь
полка	shelf	g pl полок
посторонний	outside, not directly involved; outsider	Вход посторонним воспрещён Private
поэтический	poetic
преступление	crime
пропадать/пропасть	to vanish, be lost, p: go missing	p: пропаду, пропадёшь, past пропал, пропала
размах	scope, range, scale
ранний	early
расход	expenditure
рейс	journey (of vehicle)
решающий	deciding, decisive
серия	series
стальной	steel (adj)
труженик	toiler, worker
целиком	entirely
август	August
аэродром	aerodrome, airfield	на аэродроме at an airfield
бесполезный	useless
бесчисленный	innumerable
бледный	pale	deck#2	due@2020-09-30 11:49:10
вначале	at first
внизу	below
задумчиво	thoughtfully, pensively
мотив	motive; motif
наливать/налить (+a)	to pour out, fill	p налью, нальёшь, past налил, налила, налило, imperative налей(те)
нападение	attack
направляться/направиться (к +d)	to make for, head for	i направляюсь; p направлюсь, направишься
напряжённый	tense	deck#2	due@2020-09-30 11:47:26
неправда	untruth; untrue
никуда	nowhere
обманывать/обмануть (+a)	to deceive	p обману, обманешь
одинокий	solitary
осенний	autumn (adj)
основывать/основать (+a)	to found	p осную, оснуёшь
откладывать/отложить (+a)	to put aside; postpone	отложу, отложишь
поздний	late
полоска	strip	g pl полосок
поступок	action, act
пристань (f)	jetty, pier, wharf	g pl пристаней
разворачивать/развернуть (+a)	to unfold; develop; expand
разбирать/разобрать (+a)	to take to pieces; make out, sort out, understand	p разберу, разберёшь, past разобрал, разобрала, разобрало
раненый	wounded
скорый	fast	скорый поезд fast train
сосредоточивать/сосредоточить (+a на +pr)	to concentrate (sth on sth)	p сосредоточить внимание на +pr to concentrate attention on sth
сотрудник	employee, official
столетие	century
страдать/по-	to suffer
темно	(it’s) dark
удивляться/удивиться (+d)	to be surprised (at)	i удивляюсь; p удивлюсь, удивишься
учительница	teacher (f)
финансовый	financial
чайник	teapot; kettle
экран	screen
бесцветный	colourless
биография	biography	deck#5	due@2020-12-28 11:57:17
блеск	shine
божий	God’s	f божья, n божье
боль (f)	pain
верста	verst (slightly over a kilometre)	nom pl вёрсты, g pl вёрст
воображение	imagination
вчерашний	yesterday’s
грозный	threatening
домик	cottage
закат	sunset
заметка	mark, (written) note	g pl заметок
квартал	block (of buildings); quarter of year
кукла	doll	g pl кукол
летний	summer (adj)
ловить/поймать (+a)	to catch	i ловлю, ловишь
модель (f)	model (of sth)
называемый	called	так называемый so-called
нарочно	deliberately
окончание	end, ending	deck#2	due@2020-09-30 11:49:15
отнюдь	not at all
пластинка	(gramophone) record; flat piece of metal or other material	g pl пластинок
плыть/по-	to sail; swim	i плыву, плывёшь, past плыл, плыла, плыло
подбирать/подобрать (+a)	to pick up; select	p подберу, подберёшь, past подобрал, подобрала, подобрало
помимо (+g)	apart from
последующий	subsequent, following
целовать/по- (+a)	to kiss	i: целую, целуешь; p поцелую, поцелуешь
превращать/превратить (в +a)	to convert, turn (into)	p превращу, превратишь
пуля	bullet	g pl пуль
пьеса	play (theatre)
рубаха	shirt
руководить (i) (+inst)	to manage, supervise	i руковожу, руководишь
сверкать (i)	to sparkle
серебряный	silver (adj)
слушаться/по- (+g)	to obey
сорт	grade, quality	nom pl сорта; высший сорт top quality
спасение	salvation, rescue
стиль (m)	style
стимул	stimulus
строиться/по-	to be built
сумасшедший	mad
то-то	that’s it, that’s right
угрожать (i) (+d)	to threaten (s.o.)
умение	ability
фантастика	fantastic, fantasy	научная фантастика science fiction
чтение	reading
верх	top	nom pl верхи
включать/включить (+a)	to include; switch on
внезапный	sudden
вслух	aloud
гордый	proud
горький	bitter
господство	domination, supremacy
делегат	delegate
дешёвый	cheap
длительный	lengthy
догонять/догнать (+a)	to catch up (with)	i догоняю; p догоню, догонишь, past догнал, догнала, догнало
естественный	natural
заяц	hare	g sg зайца
коли	if (coll)	= если (also коль)
кора	bark, rind, crust	no pl
летать/по-	to fly around
лётчик	pilot, airman
луг	meadow	pr sg на лугу, nom pl луга
мгновение	moment
напротив	opposite; on the contrary
незнакомый	unfamiliar
нерв	nerve
публиковать/о- (+a)	to publish	i публикую
отдыхать/отдохнуть	to rest; have/take a holiday
оценка	assessment	g pl оценок
поэзия	poetry
предыдущий	preceding
приветствовать (i) (+a)	to greet	i приветствую
применяться/примениться	to be used; (к +d) adapt os (to)	i применяюсь
разрушение	destruction
ресурс	resource
ругаться (i)	to swear
сознательный	(politically, socially) conscious; deliberate
сравнивать/сравнить (+a с +inst)	to compare (sth with sth)
удовлетворение	satisfaction
уничтожение	annihilation, destruction
эй	hey! (attracting attention)
агрессор	aggressor
бешеный	mad; furious
бормотать/про-	to mumble	i бормочу, бормочешь
вдали	in the distance
ведро	bucket	nom pl вёдра, g pl вёдер
всемирный	world, worldwide
вырываться/вырваться	to tear oneself away	p вырвусь, вырвешься
высказывать/высказать (+a)	to express	p выскажу, выскажешь
выставка	exhibition	g pl выставок; на выставке at an exhibition
дневной	day (adj)
довод	argument (for sth)
дожидаться/дождаться (+g)	to wait (for)	p дождусь, дождёшься, past дождался, дождалась
доказательство	proof
железнодорожный	railway (adj)
выходить/выйти замуж (за +a)	to marry a husband
замысел	scheme, idea
зона	zone	deck#4	due@2020-10-29 11:57:05
игрок	player	g sg игрока
исключительный	exceptional
июнь (m)	June
король (m)	king	g sg короля
лавка	bench; small shop	g pl лавок
людской	human (adj)
наносить/нанести (+a +d)	to inflict (sth on s.o.), pile up	i наношу, наносишь; p нанесу, нанесёшь, past нанёс, нанесла
настойчиво	insistently
неловко	awkwardly
обеспечение	securing, providing, provision (with)
обмен	exchange
объясняться/объясниться	to make os understood; be explained; explain os	i объясняюсь
окружающий	surrounding
оправдывать/оправдать (+a)	to justify; acquit
освобождаться/освободиться (от +g)	to free os; become free	p освобожусь, освободишься
отказ	refusal
откровенно	frankly
отзываться/отозваться (на +a)	to respond to; affect; (o +pr) express a view of; give an opinion of	p отзовусь, отзовёшься, past отозвался, отозвалась
подробность (f)	detail
полагаться/положиться (на +a)	to rely (on)	p положусь, положишься
постель (f)	bedding, bed
превышать/превысить (+a)	to exceed	p превышу, превысишь
привычный	customary
приглашать/пригласить (+a)	to invite	p приглашу, пригласишь
провинция	province; provinces
прохаживаться/пройтись	to take a walk	p пройдусь, пройдёшься, past прошёлся, прошлась
различие	difference
ранить (i/p) (+a)	to wound, injure	i/p
склон	slope
сохранение	preservation
тесно	tightly; crowded
тетрадь (f)	exercise book
топор	axe	g sg топора
трогать/тронуть (+a)	to touch	p трону, тронешь
тщательно	thoroughly
угрюмо	gloomily
упорный	persistent
шкаф	cupboard	pr в/на шкафу
щель (f)	chink, fissure, slot
юг	south	на юге in the south
японский	Japanese (adj)
балкон	balcony
бокал	wineglass
бродить/по-	to wander	i брожу, бродишь
вовремя	on time	deck#2	due@2020-09-30 11:47:48
волновать/вз- (+a)	to worry, excite, disturb (s.o.)	i волнует
всерьёз	seriously
вход	entrance	deck#4	due@2020-10-29 11:53:01
гроб	coffin	pr sg в гробу, nom pl гробы
девка	girl (coll)	g pl девок
действующий	functioning	действующий вулкан active volcano
делегация	delegation
десятый	tenth
заметный	noticeable
заранее	in advance
защитник	defender
звон	ringing
исполнять/исполнить (+a)	to carry out, fulfil;  perform	i исполняю
какой-либо	any
кандидат	candidate
кирпич	brick	g sg кирпича
краткий	short
куча	heap	due@2020-09-29 11:47:57
лидер	leader
ложка	spoon	g pl ложек
любоваться/по- (+inst or на +a)	to admire	i любуюсь; p полюбуюсь
минувший	past
направо	to the right
невозможный	impossible
ненависть (f)	hate
нитка	thread	g pl ниток
общественность (f)	the public
окончательный	final
отражать/отразить (+a)	to reflect; repulse	p отражу, отразишь
отчаяние	despair
охотно	willingly
пасха	Easter	на пасху at Easter	due@2020-09-29 11:48:08
письменный	written; writing (adj)	в письменном виде in written form; письменный стол desk
по-видимому	seemingly
покончить (р) (с +inst)	to finish (with), do away with	no i
почта	post office; post, mail	на почте at the post office
премия	bonus; prize
препятствие	obstacle
призывать/призвать	to summon, appeal	p призову, призовёшь, past призвал, призвала, призвало
природный	natural
происхождение	origin
проникать/проникнуть (в +a)	to penetrate (sth)	p past проник, проникла
ровный	level; even, equal
самолюбие	pride, self-esteem
светить (i)	to shine	i светит
свидетельство	evidence; certificate
совершаться/совершиться	to be accomplished
суть (f)	essence	суть дела the heart of the matter
убеждение	conviction, belief
удерживать/удержать (+a)	to hold back, retain; hold onto; restrain	p удержу, удержишь	due@2020-09-29 11:47:42
ценить (i) (+a)	to value	i ценю, ценишь
благодарный	grateful
воспитывать/воспитать (+a)	to educate, bring up
вспыхивать/вспыхнуть	to blaze up, flare up
в-третьих	thirdly
выгонять/выгнать (+a)	to expel, drive out	i выгоняю, выгоняешь; p выгоню, выгонишь
вытягивать/вытянуть (+a)	to stretch out
гений	genius	deck#2	due@2020-09-30 11:48:59
героический	heroic
зарабатывать/заработать (+a)	to earn
изволить (+inf)	to wish, desire; deign	i изволю, изволишь; Извольте выйти Kindly leave
интересовать/за- (+a)	to interest	i интересует; p заинтересует
ишь	look (drawing attention to sth) (coll)	Ишь какой грязный! Look how dirty it is!
классический	classical
климат	climate
марш	march
медведь (m)	bear
мрачный	gloomy, baleful
наполнять/наполнить (+a)	to fill	i наполняю
недавний	recent
неизбежно	inevitably
неподвижный	motionless
освещение	illumination
оттенок	shade, nuance
папка	file, folder	g pl папок
повышать/повысить (+a)	to raise	p повышу, повысишь
понадобиться (р)	to be necessary	p понадобится; если понадобится if necessary
приступать/приступить (к +d)	to get down to, start on	p приступлю, приступишь
продолжение	continuation	Продолжение следует То be continued
проявление	manifestation, display
публика	public
будить/раз- (+a)	to wake, rouse	p разбужу, разбудишь
разница	difference	no pl
решётка	grating, grille, railings	g pl решёток
свинья	pig	nom pl свиньи, g pl свиней, d pl свиньям
свистеть/свистнуть	to whistle	i свищу, свистишь
скромный	modest
слегка	slightly
смертный	fatal; mortal
снижение	lowering
сочетание	combination
тряпка	rag	g pl тряпок
философский	philosophical
царство	kingdom
этаж	floor, storey	g sg этажа
банк	bank (for money)
блестеть (i)	to shine	i блещу, блестишь or блещешь
братец	old man, mate (form of address)
величие	greatness
голодный	hungry
громкий	loud
дважды	twice
ежегодно	annually
запасной (or запасный)	spare, reserve	or запасный
запись (f)	recording; written record
засыпа́ть (i) (+a +inst)	to fill sth, cover sth with sth	p: засы́пать
знакомство (с +inst)	acquaintance (with), knowledge (of)
избирать/избрать (+a)	to choose, elect; select	p изберу, изберёшь, past избрал, избрала, избрало
изредка	occasionally
имущество	property, possessions
кость (f)	bone	g pl костей
манера	manner
несчастье	misfortune	deck#2	due@2020-09-30 11:48:06
нетрудно	(it’s) not difficult
оркестр	orchestra
отдалённый	distant, remote
откровенный	frank
ошибаться/ошибиться	to make a mistake	p ошибусь, ошибёшься; past ошибся, ошиблась
пёстрый	many-coloured, motley
вешать/повесить (+a)	to hang	p повешу, повесишь
помещать/поместить (+a)	to accommodate, place	p помещу, поместишь
предположение	supposition
предупреждать/предупредить (+a о +pr)	to warn (s.o. about sth), tell in advance	p предупрежу, предупредишь
проживать/прожить	to reside; (p) live for a specified period	p проживу, проживёшь, past прожил, прожила, прожило
пятьсот	five hundred	g пятисот, d пятистам, inst пятьюстами, pr пятистах
равенство	equality
рассуждать (i)	to reason; (o +pr) discuss
сзади	from behind
сибирский	Siberian (adj)
скатерть (f)	tablecloth	g pl скатертей
смирно	quietly
соображение	consideration, reason	из соображений безопасности for security reasons
специально	specially
стрела	arrow	nom pl стрелы
струя	jet, stream	nom pl струи, g pl струй, d pl струям
узел	knot; junction; bundle	g sg узла
усмешка	slight smile; sneer; smirk	g pl усмешек
успешный	successful
учебный	educational
яблоко	apple	nom pl яблоки, g pl яблок
аккуратно	thoroughly; tidily
бедствие	disaster
ближний	near
бытовой	social, everyday
введение	introduction
владеть/о- (+inst)	to possess; have command of; to master	владею, владеешь; Она владеет пятью языками She speaks five languages
возрастать/возрасти	to grow	p возрасту, возрастёшь; past возрос, возросла
гаснуть/по-	to go out, be extinguished, fade	i гасну, гаснешь, past гас, гасла
данные (pl)	data; qualities	(pl)
девица	girl
дневник	diary	g sg дневника
дружественный	friendly
заведующий (+inst)	manager, head (of)
исследователь (m)	researcher
истинный	true	deck#2	due@2020-09-30 11:48:15
картинка	picture, illustration	g pl картинок
когда-нибудь	ever; some day
коса	plait; scythe	nom pl косы; (а ко́су) plait; (а косу́) scythe
кошка	cat (f)	g pl кошек
кризис	crisis
кусочек	small piece
милиция	police
молния	lightning
мышь (f)	mouse	g pl мышей
намерение	intention
натура	nature, character
оканчивать/окончить (+a)	to finish; graduate (from)
отчёт	report
поворачиваться/повернуться	to turn round
повышенный	raised
политик	politician
почётный	respected
преодолевать/преодолеть (+a)	to overcome	p преодолею, преодолеешь
продавать/продать (+a)	to sell	i продаю, продаёшь; p продам, продашь, продаст, продадим, продадите, продадут, past продал, продала, продало
прохожий (m) (adj)	passer-by
прыгать/прыгнуть	to jump
пугать/ис- (+a)	to frighten
пыльный	dusty
российский	Russian (of Russia)	deck#4	due@2020-10-29 11:48:11
ругать/вз- (+a)	to abuse, scold	вз-/из-/об- р
свадьба	wedding	g pl свадеб
сладкий	sweet
станок	machine, machine tool	печатные станки printing presses
скука	boredom	due@2020-09-29 11:54:18
снежный	snow (adj), snowy
сокращение	reduction; abbreviation
солдатский	soldier’s
суббота	Saturday
таинственный	mysterious
толкать/толкнуть (+a)	to push, shove
ущерб	damage	в ущерб +d to the detriment of
хитрый	cunning
честно	honestly
чиновник	bureaucrat; official
штаны (m) (pl)	trousers	g pl штанов
буфет	snackbar
быстрота	speed
вынуждать/вынудить (+a +inf)	to force, compel	p вынужу, вынудишь	due@2020-09-29 11:56:56
выходной	exit (adj)	выходной день day off
заботиться/по- (о +pr)	to worry about, concern os with, look after; take care of	i забочусь, заботишься
завидовать/по- (+d)	to envy	i завидую, завидуешь
закуривать/закурить (+a)	to start smoking, light up (cigarette etc.)	p закурю, закуришь	deck#2	due@2020-09-30 11:47:17
зарубежный	foreign
империя	empire
испытывать/испытать (+a)	to test; experience
камера	chamber, room, cell
категория	category
колхозник	collective farmer
колхозный	collective farm (adj)
ложь (f)	lie, lies	no pl
милость (f)	favour	Милости просим! Welcome!
монета	coin
мчаться/по-	to rush	i мчусь, мчишься	due@2020-09-29 11:49:19
мышление	thinking
небось	probably (coll)
определяться/определиться	to be determined, be defined	i определяется
пасть (f)	maw, jaws (of animal)
подходящий	suitable
пожимать/пожать (+a)	to press, squeeze	i пожимать руку +d to shake s.o.’s hand; p пожму, пожмёшь
поздравлять/поздравить (+a с +inst)	to congratulate (s.o. on sth)	i поздравляю; p поздравлю, поздравишь
поперёк (+g)	across	стоять поперёк дороги to be in the way; вдоль и поперёк far and wide
поручать/поручить (+a +d)	to entrust sth to s.o.	p поручу, поручишь
прижимать/прижать (+a к +d)	to press, clasp (sth to sth)	p прижму, прижмёшь
противно	disgusting(ly)
проявлять/проявить (+a)	to display, manifest	i проявляю; проявлять инициативу to show initiative; p проявлю, проявишь
рабство	slavery
радостно	joyfully
резать/по- (+a)	to cut	i режу, режешь; по-/на-/раз- р
сантиметр	centimetre
сверх (+g)	above
свидетель (m)	witness
седой	grey (of hair)
скот	cattle	g sg скота
скрываться/скрыться	to hide os, vanish
сырой	damp; raw	сырое мясо raw meat
тактика	tactics	no pl
телефонный	telephone (adj)
течь/по-	to flow; begin to flow	i теку, течёшь, текут; past тёк, текла
течь (f)	leak	дать течь to spring a leak
тупик	cul-de-sac, dead-end
уверенно	confidently
усмехаться/усмехнуться	to smile slightly, give a short laugh	p: усмехнусь, усмехнёшься
утверждение	assertion; confirmation
хлопать/хлопнуть (+inst)	to bang, slap, clap
холод	cold
шептать/шепнуть	to whisper	i шепчу, шепчешь
эффект	effect
ай	oh! (expressing fear, surprise)
бельё	linen	нижнее бельё underwear
берёза	birch
бородатый	bearded
ведущий	leading; (as noun) presenter (of programme)
визит	official visit
возмущение	indignation
возражать/возразить (против +g)	to object (to)	p возражу, возразишь
восклицать/воскликнуть	to exclaim
выделяться/выделиться (из +g)	to stand out (from)
выпадать/выпасть (из +g)	to fall out (of)	p выпаду, выпадешь; past выпал, выпала
где-нибудь	anywhere
горшок	pot
гроза	thunderstorm	nom pl грозы
грустный	sad
доноситься/донестись	to reach (sounds etc.)	i доносится; p донесётся, past донёсся, донеслась
единица	unit
жадный	greedy
забирать/забрать (+a)	to take hold of; take away	p заберу, заберёшь, past забрал, забрала, забрало
задавать/задать (+a +d)	to set, assign (sth to s.o.)	i задаю, задаёшь; задавать вопрос to ask а question; p задам, задашь, задаст, зададим, зададите, зададут, past задал, задала, задало
задерживаться/задержаться	to be delayed	p задержусь, задержишься
закладывать/заложить (+a)	to put behind; lay down, found; (+inst) block (with); pawn, mortgage	p заложу, заложишь
занавеска	curtain	g pl занавесок
запирать/запереть (+a)	to lock	p запру, запрёшь; past запер, заперла, заперло
издавать/издать (+a)	to publish; emit	i издаю, издаёшь; p издам, издашь, издаст; издадим, издадите, издадут, past издал, издала, издало
испуганно	fearfully
каков	what, what kind of	f какова, n каково, pl каковы; Каков он? What’s he like?
любитель (m)	amateur; lover (of sth)	любитель музыки music lover
мебель (f)	furniture	no pl
медленный	slow
нарядный	well-dressed
неизбежный	inevitable	deck#2	due@2020-09-30 11:55:55
ненавидеть/воз- (+a)	to hate	i ненавижу, ненавидишь
обсуждать/обсудить (+a)	to discuss	p обсужу, обсудишь
опираться/опереться (на +a)	to lean on	p обопрусь, обопрёшься, past опёрся, оперлась
освещать/осветить (+a)	to illuminate	p освещу, осветишь
отворачиваться/отвернуться (от +g)	to turn away (from)
отрицать (i) (+a)	to deny
перевод	translation; transfer
плата	payment
подвергаться/подвергнуться (+d)	to undergo, be subjected to
подымать/поднять (+a)	to raise (coll)	= поднимать i
полно́ (+g)	lots (of) (coll)	Было полно народа There were lots of people
по́лно	that’s enough; full	Полно жаловаться Stop complaining
положительный	positive	deck#2	due@2020-09-30 11:55:28
попадаться/попасться	to be caught; turn up	p попадусь, попадёшься, past попался
преследовать (i) (+a)	to pursue; persecute	i преследую, преследуешь
пресса	the press
прокурор	prosecutor
просторный	spacious
раздаваться/раздаться	to resound	i раздаётся; p раздастся, past раздался, раздалась
разработка	elaboration, working out; design; mining
разумный	sensible
рамка	frame	g pl рамок
расширение	expansion
сверкающий	sparkling
семнадцать	seventeen
словом	in short
складывать/сложить (+a)	to pile up, put together; fold up; add up; put down	p сложу, сложишь
срывать/сорвать (+a с +g)	to tear off; wreck	p сорву, сорвёшь, past сорвал, сорвала, сорвало
табак	tobacco	g sg табака
теперешний	present (adj) (coll)
уголок	corner, nook
учёт	calculation; stock-taking; registration
фон	background
фонд	fund; stock
фунт	pound (money or weight)
халат	dressing-gown; overall, white coat
четырнадцать	fourteen
электростанция	power station
африканский	African (adj)
барин	landowner, barin; gentleman	nom pl баре or бары, g pl бар
барышня	young lady	g pl барышень
больший	bigger
вдвое	double	вдвое больше twice as much
ветка	branch	g pl веток
владёлец	owner	g sg владельца
волк	wolf	nom pl волки, g pl волков
выдумывать/выдумать (+a)	to invent, fabricate, make up
выигрывать/выиграть (+a)	to win
выясняться/выясниться	to become clear
гнев	anger
давний	long-ago (adj)
денежный	money (adj), monetary
добывать/добыть (+a)	to get, obtain	p добуду, добудешь, past добыл, добыла, добыло
драка	fight, brawl
живот	belly, stomach	g sg живота
закономерность (f)	regularity, law	due@2020-09-29 11:56:06
заслуга	service, merit, achievement
издали	from a distance
иллюзия	illusion
качать/качнуть (+a or +inst)	to rock, shake, swing	i качать головой to shake one’s head
квадратный	square (adj)
красавица	beautiful woman
ласковый	tender, affectionate
минеральный	mineral (adj)	минеральная вода mineral water
мягко	softly
недалеко	not far	Почта недалеко The post office is not far
облик	look, appearance, image
обломок	fragment
одеяло	blanket
опускаться/опуститься	to lower os, sink	p опущусь, опустишься
осколок	splinter
осуществлять/осуществить (+a)	to carry out, accomplish, execute	i осуществляю; p: осуществлю, осуществишь
помирать/помереть	to die (coll)	p помру, помрёшь; past помер, померла, померло
поражение	defeat
праздничный	festive
предоставлять/предоставить (+a +d)	to give, grant (sth to s.o.)	i предоставляю; p предоставлю, предоставишь
пропускать/пропустить (+a)	to let through; omit, miss	пропущу, пропустишь
разведка	intelligence service; reconnaissance
распространяться/распространиться	to spread	i распространяется
рубеж	boundary	g sg рубежа; g sg рубежа; за рубежом abroad
сарай	shed
сиять (i)	to shine	i сияю, сияешь
советовать/по- (+d)	to advise (s.o.)	i советую, советуешь; p посоветую
современник	contemporary
сок	juice	pr sg в соку
соображать/сообразить	to realize, work out, think out, understand	p соображу, сообразишь
сопровождать (i) (+a)	to accompany
сохраняться/сохраниться	to be preserved	i сохраняюсь
структура	structure
ступень (f)	step, rung; stage, level, grade	g pl ступеней
стыд	shame	g sg стыда
тайный	secret (adj)
угнетённый	oppressed
уснуть (p)	to fall asleep
утренний	morning (adj)
философ	philosopher
холодно	coldly; it’s cold
аудитория	auditorium
базар	bazaar, market
бронзовый	bronze (adj)
валяться/по-	to roll; lie about	i валяюсь, валяешься
верёвка	rope; string	g pl верёвок
взволнованный	anxious, agitated
временный	temporary
выбрасывать/выбросить (+a)	to throw out	p выброшу, выбросишь
глупо	stupidly
долина	valley
дополнительный	additional
дуть/по-	to blow	i дую, дуешь
жалкий	pitiful
зажигать/зажечь (+a)	to set fire to	p зажгу, зажжёшь, зажгут; past зажёг, зажгла
засыпать/заснуть	to fall asleep
заставать/застать (+a)	to find (a person)	p застану, застанешь
здороваться/по- (c +inst)	to greet	i здороваюсь
известие	piece of news
искренний	sincere
килограмм	kilogram
крыса	rat
мелочь (f)	trifle, minor matter; small change (coins)	g pl мелочей
молодёжный	youth (adj)
мыть/по- (+a)	to wash	i мою, моешь
недостаточно	insufficient(ly); (+g) not enough
немногие (pl)	few (people)
неприятный	unpleasant
огород	kitchen-garden (for vegetables)
описывать/описать (+a)	to describe	p опишу, опишешь
отреза́ть (i) (+a)	to cut off	p отре́зать, отре́жу, отре́жешь
охватывать/охватить (+a)	to seize, envelop	p охвачу, охватишь
плёнка	film, (recording) tape	g pl плёнок
подземный	underground (adj)
#METADATA:
#--decks immediate,daily,weekly,monthly,quarterly,yearly
#--intervals 0,1440,10080,43200,129600,518400
#--listdelimiter |
#--columns russian,english,extra
#--showcolumns russian
#--showcolumns english,extra
