показываться/показаться	to show os, be shown
порой	at times, occasionally
порядочный	decent, respectable
прикрывать/прикрыть (+a +inst)	to screen, shelter (sth with sth)	p прикрою, прикроешь
прилагать/приложить (к +d)	to place in contact with; apply; add, attach (to)	i прилагать (все) усилия к +d to make every effort to; p приложу, приложишь; прикладывать i/прилагать i
разводить/развести (+a)	to separate; dissolve	i развожу, разводишь; p разведу, разведёшь, past развёл, развела
разглядывать (i) (+a)	to examine closely	no р
роща	small wood, copse
случайный	chance (adj), fortuitous
смело	boldly
смущённо	with embarrassment
создаваться/создаться	to be created; arise	i создаётся; p создастся
сохранять/сохранить (+a)	to keep, preserve	i сохраняю, сохраняешь
спускаться/спуститься	to go down, descend	p спущусь, спустишься
сумерки (pl)	twilight, dusk	g pl сумерек
тяжесть (f)	weight, burden
увеличиваться/увеличиться	to increase
фашизм	Fascism
автомашина	car, vehicle
беспощадный	merciless
брак	marriage; (no pl) defective product(s), reject(s)
брошюра	brochure
бугор	mound
вечно	eternally, always
возить/по- (+a)	to transport (around/there and back)	i вожу, возишь
вплоть (до +g)	right up to
выделять/выделить (+a)	to pick out; allot, assign	i выделяю, выделяешь
выезжать/выехать (из +g)	to leave (by transport)	p выеду, выедешь
вытирать/вытереть (+a)	to wipe, wipe dry	p вытру, вытрешь; past вытер, вытерла
газетный	newspaper (adj)
голосовать/про- (за +a/против +g)	to vote (for/against)	i голосую, голосуешь
дуб	oak	nom pl дубы
жалоба (на +a)	complaint (about)
заболевать/заболеть	to fall ill
заводить/завести (+a)	to take somewhere; start, start up; wind up	i завожу, заводишь; p заведу, заведёшь, past завёл, завела
закрытый	closed
катиться/по-	to roll	i качусь, катишься; Пот катился со лба Sweat was rolling down his forehead
книжный	book (adj); bookish
крутить/за- (+a)	to twist	i кручу, крутишь; за-/с-/по- p
ловко	skilfully, deftly
лопата	spade
магнитофон	tape-recorder
мастерство	skill, craftsmanship
мужество	courage
наверху	above; upstairs
награда	reward
наряду (с +inst)	equally, alongside
необыкновенный	unusual
овца	sheep	nom pl овцы, g pl овец, d pl овцам
относить/отнести (+a)	to take (somewhere)	p отнесу, отнесёшь; past отнёс, отнесла
падение	fall
подводить/подвести (+a)	to lead up; (coll) let (s.o.) down	i подвожу, подводишь; подводить итоги to sum up
подозревать (i) (+a)	to suspect	no p
поистине	indeed
покойный	calm; late, deceased
посещать/посетить (+a)	to visit (a place)	p посещу, посетишь
постановление	resolution, decree
пот	sweat	pr sg в поту
пребывание	stay
предварительный	preliminary; prior
приготавливать/приготовить (+a)	to prepare	p приготовлю, приготовишь
пристально	fixedly	смотреть пристально на +а to stare at
протяжение	extent; expanse	на протяжении (+g) during
разнообразие	variety
рассматривать/рассмотреть (+a)	to examine; make out	p рассмотрю, рассмотришь
рвать/по- (+a)	to tear	i рву, рвёшь, past рвал, рвала, рвало
религия	religion
родственник	relative
сбивать/сбить (+a)	to knock down; confuse; whip, whisk; distract, beat	p собью, собьёшь
сворачивать/свернуть (+a)	to roll (up); turn	p Она свернула налево She turned left
сводить/свести (+a)	to take (s.o. somewhere); bring together; (c +g) take down, away	i свожу, сводишь/p сведу, сведёшь, past свёл, свела
скамейка	bench	g pl скамеек
совершенствование	improvement
сокровище	treasure
сплошь	completely	сплошь и рядом very frequently
судья (m/f)	judge; referee	nom pl судьи, g pl судей, d pl судьям
существующий	existing
толщина	thickness
видать/у- (+a)	to see (coll)
ужин	supper
усадьба	country estate	g pl усадеб and усадьб
хранить (i) (+a)	to keep, store
чашка	cup	g pl чашек
чепуха	nonsense
явный	obvious, overt
бревно	log, beam	nom pl брёвна, g pl брёвен
виднеться (i)	to be visible	i виднеется
вклад	contribution
восстанавливать/восстановить (+a)	to restore, reconstruct; (+a против +g) set s.o. against s.o.	p восстановлю, восстановишь
временно	temporarily
вызов	summons; challenge
вылезать/вылезти (из +g)	to climb out (of)	p вылезти or вылезть; p вылезу, вылезешь; past вылез, вылезла
годовой	yearly
готовность (f)	readiness
доступный	accessible
жарко	hotly; it’s hot
задумывать/задумать (+a)	to think up; plan
запрос	official request
издалека	from a distance
интересоваться/за- (+inst)	to be interested in	i интересуюсь, интересуешься
кадр	frame; cadre
кадры	staff, personnel	m pl
каковой	which (official style)	= который/какой
кивать/кивнуть (+inst)	to nod
китайский	Chinese
корм	fodder
красиво	beautifully, attractively
кровавый	bloody
крышка	lid	g pl крышек
кушать/с- (+a)	to eat	по- p/с- р
напиваться/напиться (+g)	to drink one’s fill; get drunk	p напьюсь, напьёшься, past напился, напилась
нарушение	violation, offence
нелегко	(it’s) not easy
нестись/по-	to rush	i несусь, несёшься; past нёсся, неслась
нить (f)	thread
ночевать/пере-	to spend the night	i ночую, ночуешь
нравственный	moral
объединённый	united	Объединённые Нации United Nations
окраина	outskirts
описание	description
остановка	stop	g pl остановок; без остановки without stopping
очевидный	obvious
очерк	essay, study
патрон	cartridge
пенсия	pension	на пенсии retired
плен	captivity	pr sg в плену
плоский	flat
плотно	tightly
подвал	cellar, basement
подчёркивать/подчеркнуть (+a)	to underline; emphasize
подыматься/подняться	to rise; climb (coll)	= подниматься
есть/по-	to eat a little	p поём, поёшь, поест, поедим, поедите, поедят, past поел, поела
полгода	half a year	g полугода
нести/по- (+a)	to carry	i: несу, несёшь; past нёс, несла; p понесу, понесёшь, past понёс, понесла
приниматься/приняться (за +a)	to get down, start work on	p примусь, примешься; past принялся, принялась
присущий (+d)	inherent (in)
притом	besides, in addition
проигрывать/проиграть (+a)	to lose (game etc)
профессиональный	professional (adj)
растерянно	in bewilderment
реклама	advertisement
руководящий	leading, guiding
сжигать/сжечь (+a)	to burn	p сожгу, сожжёшь, сожгут, past сжёг, сожгла
скамья	bench	g pl скамей
скучный	boring
снизу	from below
собеседник	interlocutor, the person one is talking to
собор	cathedral
спинка	back (of chair etc.)	g pl спинок
прятаться/с-	to hide	i прячусь, прячешься; p спрячусь, спрячешься
стукать/стукнуть (+a)	to knock, bang
торопливо	hastily
тревожить/вс- (+a)	to alarm; disturb	вс- р; по- р
убитый	killed
худой	thin; bad	на худой конец if the worst comes to the worst
чрезвычайный	extreme; exceptional
шагать/шагнуть	to step, stride; to take a step
эффективность	effectiveness; efficiency
якобы	allegedly
ярость (f)	rage
аллея	avenue
баня	bath-house
беспокойство	agitation, anxiety
беспорядок	disorder, mess
близ (+g)	near
бурый	greyish-brown	бурый медведь brown bear
валить/с- (+a)	to topple; heap up	i валю, валишь; p: по- or с-
веде́ние	conducting, conduct
ве́дение	authority, control
величественный	majestic
вздумать (р) (+inf)	to decide suddenly (coll)	no i
вмешательство (в +a)	interference (in)
водный	water (adj)
возвращение	return
гриб	mushroom	g sg гриба
гусь (m)	goose	nom pl гуси, g pl гусей
девятый	ninth
еда	food
жестоко	cruelly
животный	animal (adj)
забастовка	strike (by workers)	g pl забастовок
за́мок	castle
замо́к	lock
затылок	back of the head
идеал	ideal
ковёр	carpet
колоссальный	colossal
куда-то	somewhere
мощь (f)	power, might
наивный	naive
налево	to the left
неведомый	unknown
неудобно	uncomfortably, awkwardly; it’s awkward
обман	deceit, deception
обходиться/обойтись	to manage; treat; turn out	i обхожусь, обходишься; p обойдусь, обойдёшься, past обошёлся, обошлась
обязывать/обязать (+a +inf)	to oblige s.o. to do sth	p обяжу, обяжешь
одерживать/одержать (+a)	to obtain, gain	p одержу, одержишь; одержать победу to be victorious
освоение	assimilation, mastery
пение	singing
переживать/пережить (+a)	to live through; experience; outlive; suffer	p переживу, переживёшь, past пережил, пережила, пережило
печатать/на- (+a)	to print
пешком	on foot
планирование	planning
повар	cook	nom pl повара
поделать (р)	to do (coll)	ничего не поделаешь it can’t be helped
познание	knowledge, cognition
полёт	flight
последствие	consequence
приблизительно	approximately
пригодиться (р)	to come in useful	p пригожусь, пригодишься
прогонять/прогнать (+a)	to drive away; banish, throw out	p прогоню, прогонишь, past прогнал, прогнала, прогнало
просвещение	education; enlightenment
прочность (f)	stability, solidity, durability
проявляться/проявиться	to show itself, be revealed	i проявляется; p проявится
пустынный	desert (adj), deserted
рана	wound
расспрашивать/расспросить (+a)	to question	p расспрошу, расспросишь
рядовой (m) (adj)	ordinary, rank and file; (as noun) private soldier
свидетельствовать (i) (о +pr)	to show, be evidence (of)	i свидетельствует
слепой	blind
трактор	tractor
штаб	staff (mil); HQ	nom pl штабы
борт	side (of a ship)	pr sg на борту; nom pl борта; на борту on board (ship or plane)
цех	section of factory, shop	pr sg в цехе or в цеху; nom pl цехи or цеха
порода	kind, type, breed; rock (geological)
германский	Germanic
о́рган	organ (biol, political)
орга́н	organ (musical instrument)
лаборатория	laboratory
казак	Cossack	g sg казака́, nom pl казаки́ (but Tolstoi’s «Каза́ки»)
металл	metal
прибор	piece of apparatus, gadget, instrument
обработка	treatment, processing	g pl обработок
видимый	visible, evident
эксплуатация	exploitation
колонна	column
рыбак	fisherman	g sg рыбака
производственный	production (adj)
полицейский	police (adj); (adj used as noun) policeman
завоевание	conquest
бригадир	brigade leader; foreman
показатель (m)	index, indicator
часовой	hour (adj); watch, clock (adj); (as noun) sentry
слушатель (m)	listener
слышный	audible
срочно	urgently
ссора	quarrel
стадия	stage (of development)
столкновение	collision, clash
ступенька	step	g pl ступенек
судно	vessel, craft	nom pl суда, g pl судов
теряться/по-/рас-	to get lost; lose one’s head	теряюсь, теряешься; по- р; рас- р
увлечение	enthusiasm; hobby
удивлённо	with surprise
умственный	mental, intellectual
учитывать/учесть (+a)	to take into account; to take into consideration, bear in mind	p учту, учтёшь, past учёл, учла
чей-то	someone’s	f чья-то, n чьё-то, pl чьи-то
яма	pit, hole
бег	running; race	pr на бегу
беспокоить/о-/по- (+a)	to worry (s.o.)	о- or по- р
бессмертный	immortal
веселье	merriment
взрывать/взорвать (+a)	to blow up	p взорву, взорвёшь, past взорвал, взорвала, взорвало
витрина	shop-window; showcase
внучка	granddaughter	g pl внучек
внушать/внушить (+a +d)	to instil, inspire (sth in s.o.), put sth in s.o.’s head
возбуждать/возбудить (+a)	to arouse	p возбужу, возбудишь
воин	warrior
гордиться (i) (+inst)	to be proud of	i горжусь, гордишься; Мы гордимся дочкой We’re proud of our daughter
горько	bitter(ly)
грустно	sad(ly)
густо	thickly; densely
доставаться/достаться (+d)	to fall to s.o.’s lot; (coll) catch it (be punished)	i достаётся; p достанется
дура	idiot, stupid woman
ежедневно	every day
заканчиваться/закончиться	to end; finish
изобретение	invention
катастрофа	disaster
колебаться/по-	to sway; hesitate	i колеблюсь, колеблешься
лампочка	(light) bulb	g pl лампочек
легенда	legend
летучий	flying	летучая мышь bat
мгла	haze, gloom
младший	younger; junior
мыслить (i)	to think
накрывать/накрыть (+a)	to cover; lay	p накрою, накроешь; накрыть (на) стол to lay the table
неплохо	not bad(ly)
ноль (m)	zero	g sg ноля
нота	note (music, diplomatic)
ноты	sheet music
обильный	abundant
оборачиваться/обернуться	to turn round; turn out
отечественный	of the fatherland; Russian
отечество	fatherland
отставать/отстать (от +g)	to lag behind	i отстаю, отстаёшь; p отстану, отстанешь
ощущение	sensation, feeling
памятный	memorable
папаша (m)	dad	= папа
патриотический	patriotic
передний	front (adj)
перерыв	break, interval
повторяться/повториться	to be repeated	i повторяется
поди	probably (coll)
подлец	scoundrel	g sg подлеца
подхватывать/подхватить (+a)	to pick up, take up	p подхвачу, подхватишь
краснеть/по-	to become red; blush, turn red	i краснею, краснеешь
поражать/поразить (+a)	to strike; astonish; rout	p поражу, поразишь
предполагать/предположить	to suppose	p предположу, предположишь
придавать/придать (+a +d)	to impart, give (sth to sth)	i придаю, придаёшь; придавать значение чему-нибудь to treat sth as important; p придам, придашь, придаст, придадим, придадите, придадут, past придал, придала, придало
приезд	arrival
пробираться/пробраться	to make one’s way through, force one’s way	p проберусь, проберёшься, past пробрался, пробралась
протест	protest
радоваться/об- (+d)	to be glad (at), be pleased (about)	i радуюсь, радуешься; p обрадуюсь
радостный	glad, joyful
разноцветный	many-coloured
расстреливать/расстрелять (+a)	to execute (by shooting)	p расстреляю
редактор	editor	nom pl редактора
рубить (i) (+a)	to chop	i рублю, рубишь
сдавать/сдать (+a)	to hand in, hand over; rent, let; surrender, give up; i: take (exam); p: to pass (exam)	i сдаю, сдаёшь; p: сдам, сдашь, сдаст, сдадим, сдадите, сдадут, past сдал, сдала, сдало
следствие	consequence; investigation
смущаться/смутиться	to be embarrassed	p смущусь, смутишься
спускать/спустить (+a)	to lower; release	p спущу, спустишь
сухо	drily
телевидение	television (medium)
телевизионный	television (adj)
тревожно	anxiously
тяжкий	heavy, serious
увлекать/увлечь (+a)	to carry away; fascinate, distract	p увлеку, увлечёшь, увлекут, past увлёк, увлекла
удобно	comfortably; conveniently; it’s convenient
уход	departure; (за +inst) caring (for), maintenance (of)	уход за ребёнком caring for а child
церковный	church (adj)
чудак	eccentric person, crank	g sg чудака
экземпляр	copy (of book etc.)
юный	young
беспокойный	anxious, agitated
бинокль (m)	binoculars
верхушка	top; (coll) the bosses	g pl верхушек
взаимоотношение	interrelation
восемьдесят	eighty	g, d, pr восьмидесяти, inst восемьюдесятью
вреза́ться (i) (в +a)	to cut into	p: вре́заться, вре́жусь, вре́жешься
выгода	advantage
вырабатывать/выработать (+a)	to produce; work out
гладить/по- (+a)	to stroke; iron	i глажу, гладишь
городок	small town
гудок	hooter, car horn; hooting
договариваться/договориться (с +inst)	to reach agreement (with)
досада	annoyance
дьявол	devil
жаркий	hot
забытый	forgotten
загадка	mystery; riddle	g pl загадок
загрязнение	pollution
искра	spark
искренне	sincerely
исполнение	fulfilment; performance
кидать/кинуть (+a)	to throw
коллега (m/f)	colleague
куда-нибудь	anywhere
мириться/по-/при- (с +inst)	to be reconciled with	по- р/при- р
молитва	prayer
молчаливый	taciturn
монах	monk
наблюдаться (i)	to be observed
наверх	upwards
наклоняться/наклониться	to bend down, stoop, bend over	i наклоняюсь; p наклонюсь, наклонишься
намечать/наметить (+a)	to plan	p намечу, наметишь
настаивать/настоять (на +pr)	to insist, get one’s own way	p настою, настоишь
наставать/настать	to come (of seasons etc.)	p настанет
обслуживание	service
объединять/объединить (+a)	to unite, combine	i объединяю
одинаково	identically
одиннадцать	eleven
опасаться (i) (+g)	to be afraid of
организатор	organizer
поглядывать (i) (на +a)	to cast looks at
полотенце	towel	g pl полотенец
работать/по-	to work, work for a while	Он работает здесь|He works here
поразительный	astonishing
постройка	building	g pl построек
преступник	criminal
привет	greeting
присутствовать (i)	to be present	i присутствую
продажа	sale
равнодушный (к +d)	indifferent (to)
расставаться/расстаться (с +inst)	to part (with/from)	i расстаюсь, расстаёшься; p расстанусь, расстанешься
растущий	growing
рваться/по-/разорваться	to tear, burst; want strongly (to do sth)	i рвусь, рвёшься, past рвался, рвалась
сеять/по- (+a)	to sow	i сею, сеешь
слабость (f)	weakness
соединяться/соединиться	to unite	i соединяются
тогдашний	then (adj)
уборка	tidying up; harvest
уверять/уверить (+a)	to assure	i уверяю, уверяешь
угадывать/угадать (+a)	to guess
удачный	successful
улучшать/улучшить (+a)	to improve
утверждать/утвердить (+a)	to confirm	p утвержу, утвердишь
учёба	study, studying
характеризовать (i/p) (+a)	to characterize	характеризую, характеризуешь; р also о-
хозяйский	owner’s; boss’s
шкура	skin, hide
шуба	fur coat
автомобильный	car (adj)
башня	tower	g pl башен
беглый	quick, fleeting
безработица	unemployment
близость (f)	closeness
вдвоём	together (as a twosome)
взамен (+g)	in exchange (for), instead (of)
врываться/ворваться (в +a)	to burst in	p ворвусь, ворвёшься, past ворвался, ворвалась
выбираться/выбраться (из +g)	to get out	p выберусь, выберешься
выдвигать/выдвинуть (+a)	to move out; put forward	p выдвину, выдвинешь
вылетать/вылететь	to fly out, take off	p вылечу, вылетишь
вырывать/вырвать (+a)	to pull out	p вырву, вырвешь
гвоздь (m)	nail	g sg гвоздя, nom pl гвозди, g pl - ей
гласность (f)	openness
гнездо	nest	nom pl гнёзда
грузовик	lorry, truck	g sg грузовика
дежурный	duty (adj); (as noun) person on duty
дорого	dearly
дружно	in harmony, simultaneously
жара	heat, hot weather
здешний	local, from here
изображать/изобразить (+a)	to depict	p изображу, изобразишь
испуганный	frightened
казённый	belonging to the State
как-нибудь	somehow; anyhow; sometime (in the future)
картошка	potatoes (coll)	no pl
кривой	squint
куртка	(short) jacket	g pl курток
лгать/со-	to lie, tell lies, tell a lie	i лгу, лжёшь, лгут, past лгал, лгала, лгало
марка	postage stamp; brand, trade mark	g pl марок
махать/по-/махнуть (+inst)	to wave	i машу, машешь; по- р/ махнуть р
митинг	political meeting
налёт	raid; thin coating
наличие	presence
некий	a certain	g sg некоего
неподалёку	not far away
неприятность (f)	unpleasantness
обвинение	accusation
обвинять/обвинить (+a в +pr)	to accuse (s.o. of sth)	i обвиняю, обвиняешь
оборот	turn, revolution; turnover; reverse (of page etc.); turn of phrase	смотри на обороте РТО
обслуживать/обслужить (+a)	to serve (s.o.)
обычай	custom
обязательный	compulsory
ого	oho!
отражение	reflection
подпись (f)	signature
подсчитывать/подсчитать (+a)	to count up, calculate
подчинять/подчинить (+a +d)	to subordinate, subject (s.o. to s.o. or sth)	i подчиняю
покидать/покинуть (+a)	to abandon
полчаса	half an hour	g sg получаса, nom pl получасы
поправлять/поправить (+a)	to correct, put right	i поправляю; p поправлю, поправишь
посетитель (m)	visitor
предпринимать/предпринять (+a)	to undertake	p предприму, предпримешь; f past предприняла
прибавлять/прибавить (+a)	to add	i прибавляю; p прибавлю, прибавишь
приговор	verdict, sentence
разделять/разделить (+a)	to divide; separate; share	i разделяю; p разделю, разделишь
смеяться/рас-	to burst out laughing	p рассмеюсь, рассмеёшься
рассуждение	reasoning, argument
ресторан	restaurant
сбрасывать/сбросить (+a)	to drop; throw off	p сброшу, сбросишь
сволочь (f)	swine, bastard (coll)	g pl сволочей
слышно	audible, audibly	Мне ничего не слышно I can’t hear anything
совместный	joint, combined
соединять/соединить (+a)	to unite, join	соединяю, соединяешь
соответствие	accordance	в соответствии с +inst in accordance with
специальность (f)	speciality; profession
срочный	urgent
старость (f)	old age	на старости лет in one’s old age
стремительно	swiftly; impetuously
стройный	harmonious; well-proportioned
схема	diagram
счастливо	happily
традиционный	traditional
тысячелетие	millennium
уважаемый	respected
уголовный	criminal (adj)
удовлетворять/удовлетворить (+a)	to satisfy; (+d) be in accordance with	i удовлетворяю
уступать/уступить (+a +d)	to yield, give up, cede (sth to s.o.)	p уступлю, уступишь
характеристика	description; reference (for job etc.)
широта	width	nom pl широты
безобразие	ugliness; scandal
беспорядочный	disorderly
благополучие	well-being
британский	British (adj)
бумажный	paper (adj)
важность (f)	importance
вблизи	close by
вглядываться/вглядеться (в +a)	to gaze at, study, look closely at, peer at	p вгляжусь, вглядишься
вековой	centuries-old
видеться/у- (c +inst)	to see one another, see each other	i вижусь, видишься
восстановление	restoration
вручать/вручить (+a)	to hand, hand over
всесторонний	all-round; thorough
гром	thunder
дружеский	friendly
дума	thought; duma (Russian parliament)
жажда	thirst
забираться/забраться (в/на +a)	to get, climb (into/onto)	p заберусь, заберёшься, past забрался, забралась
заведение	institution	высшее учебное заведение (вуз) institution of higher education
задерживать/задержать (+a)	to delay; arrest	p задержу, задержишь
законный	legal
затрата	expense
избегать/избежать (+g or inf)	to avoid	p избегу, избежишь, избегут
извиняться/извиниться (перед +inst)	to apologize (to)	i извиняюсь
качаться/качнуться	to rock, swing
кипеть/вс-	to boil, be boiling	i киплю, кипишь
клевета	slander
коробка	box	g pl коробок
лекарство	medicine
миг	moment
миновать (i/p)	to pass, pass by	миную, минуешь; Опасность миновала The danger has passed
морда	snout, muzzle; (coll) face
мутный	turbid, clouded
нарушать/нарушить (+a)	to disturb, violate, break, infringe	нарушить правило to break a rule
небывалый	unprecedented; (coll) inexperienced
некуда	there is nowhere	Некуда идти There is nowhere to go
немалый	considerable
неправильно	incorrectly
неправильный	incorrect
нищета	poverty
обстоять (i)	to be	Как обстоит дело? How’s it going?
общежитие	hostel
определение	definition
оратор	orator, speaker
осторожный	careful, cautious
отражаться/отразиться	to be reflected	p отражусь, отразишься
охранять/охранить (+a)	to guard	i охраняю
очаг	hearth	g sg очага
переносить/перенести (+a)	to transfer, carry over; postpone	i переношу, переносишь; p перенесу, перенесёшь, past перенёс, перенесла
повсюду	everywhere
подпольный	underground (adj)
полдень (m)	midday	g полудня
порывать/порвать (+a)	to tear; break off	p порву, порвёшь, f past порвала; порвать отношения с кем-нибудь to break off relations with s.o.
поручение	commission, errand
посреди (+g)	in the middle (of)
требоваться/по-	to be necessary, be needed	i: требуется; p потребуется
предстоящий	forthcoming, imminent
привлекать/привлечь (+a)	to attract	p привлеку, привлечёшь, привлекут, past привлёк, привлекла
проваливаться/провалиться	to fall through; (coll) fail (exam); (coll) vanish	p провалюсь, провалишься
происшествие	incident, occurrence
пусто	(it’s) empty; emptily	В комнате пусто The room is empty
пустота	emptiness
решимость (f)	determination, resoluteness
рождать/родить (+a)	to give birth	p рожу, родишь, f past родила; рож(д)ать i
свободно	freely
священный	holy, sacred
смелость (f)	bravery, courage
текст	text
товарный	goods (adj)	товарный знак trade mark
турист	tourist; hiker
убийство	murder
убыток	loss
укладывать/уложить (+a)	to lay (down); pack, stack	p уложу, уложишь
упражнение	exercise
цивилизация	civilization
чин	rank	nom pl чины
шевелиться/по-	to stir	p: по-/шевельнуться
автобус	bus
бесспорно	indisputably
бесстрашный	fearless
благодарность (f)	gratitude
брюки (pl)	trousers	g pl брюк
вождь (m)	leader	g sg вождя
вспышка	flash	g pl вспышек
вытекать/вытечь	to flow out	i Отсюда вытекает, что ... It follows from this that...
гладкий	smooth
грубо	coarsely
давить (i) (на +a)	to press, put pressure on	i давлю, давишь
двадцатый	twentieth
делиться/раз- (на +a)	to be divided (into)	i делюсь, делишься
дескать	(indicating reported speech) ‘he said’, ‘they said’ etc. (coll)	Он, дескать, женился I heard he’d got married
дрянь (f)	rubbish (coll)
завтрак	breakfast
замечание	remark
зелень (f)	greenery
наглядный	clear, graphic
нагрузка	load; workload
надобность (f)	necessity, need
недолго	not (for) long
недоступный	inaccessible
независимо	independently
неясный	unclear
нуль (m)	zero	g sg нуля
ограниченный	limited
осматривать/осмотреть (+a)	to examine; look round (sth), inspect	p осмотрю, осмотришь
отвергать/отвергнуть (+a)	to reject
пиво	beer
побережье	coast
подальше	a little further (coll)
ползти/по-	to crawl	i ползу, ползёшь, past полз, ползла
прибегать/прибегнуть (к +d)	to run to; resort to	p also прибежать | прибегнуть - to resort to; прибежать - to run to
противный	disgusting
пушистый	fluffy, downy
пышный	luxuriant
разбитый	broken
сбоку	from the side
валиться/с-	to fall down	p свалишься; валиться i/сваливаться i
симпатия (к +d)	liking (for s.o.)
сказочный	fairy-tale (adj)
слабо	weakly
сладко	sweetly
справедливо	justly, fairly; correctly
сталкиваться/столкнуться (с +inst)	to collide with
сторонник	supporter
типичный	typical
тонуть/по-/у-	to sink; drown	i тону, тонешь; по-/у- p
трамвай	tram, streetcar
тротуар	pavement, sidewalk
увлекаться/увлечься (+inst)	to be keen on
уводить/увести (+a от +g)	to lead away	i увожу, уводишь; p уведу, уведёшь, past увёл, увела
хор	chorus; choir	nom pl хоры
четверо	four, foursome	У них четверо детей They have four children
чистота	cleanliness; purity
босой	barefoot
вертеть/по-	to twirl	i верчу, вертишь
всходить/взойти (на +a)	to ascend	p взойду, взойдёшь, past взошёл, взошла; всходить i/восходить i
вмешиваться/вмешаться (в +a)	to interfere (in)
вольный	free
воротник	collar	g sg воротника
выдумка	invention; fabrication, lie	g pl выдумок
выслушивать/выслушать (+a)	to hear (s.o.) out
выставлять/выставить (+a)	to display, put forward	i выставляю; p выставлю, выставишь
грусть (f)	sadness
даваться/даться (+d)	to be given; come easily (to s.o.), be learnt easily	i даётся; p дамся, дашься, дастся, дадимся, дадитесь, дадутся, past дался, далась
дата	date
дипломат	diplomat; attaché-case
единственно	only
жать/с- (+a)	to squeeze; to harvest	squeeze: жму, жмёшь; harvest: жну, жнёшь
жулик	petty thief; cheat
завтрашний	tomorrow’s
звенеть/за-	to ring; (+inst) jingle	i звеню, звенишь
игрушка	toy	g pl игрушек
излагать/изложить (+a)	to set out, expound, put in words	p изложу, изложишь
исправлять/исправить (+a)	to correct	p исправлю, исправишь
кафе (n) (indecl)	café
каша	kasha (porridge made of buckwheat, semolina or oatmeal)
коллективный	collective
контора	office
маршрут	route
могущество	power, might
наделать (р) (+g)	to make; (coll) to do	наделать глупостей to do a lot of stupid things
наружу	outside
невиданный	unprecedented
невысокий	low, short
недостаточный	insufficient
незначительный	insignificant
необычный	unusual
неподвижно	motionlessly, still
нервный	nervous
ничуть	not in the least (coll)
ножка	leg; stem (of wineglass, mushroom)	g pl ножек
облегчать/облегчить (+a)	to lighten; simplify; make easier
обрывать/оборвать (+a)	to tear off; interrupt	p оборву, оборвёшь, f past оборвала
обрабатывать/обработать (+a)	to process, work on
обувь (f)	footwear	no pl
ожидание	waiting; expectation
опора	support
отдельно	separately
отбирать/отобрать (+a)	to take away; select	p отберу, отберёшь, f past отобрала
отрываться/оторваться (от +g)	to be torn off, break away	p оторвусь, оторвёшься, past оторвался, оторвалась
отрицательный	negative
отчаянный	desperate
очутиться (р)	to find oneself	no 1st pers sg, очутишься; no i
песенка	song	g pl песенок
побольше	a bit more
быть/по-	to stay for a while	p побуду, побудешь, past побыл, побыла, побыло
подсказывать/подсказать (+a)	to prompt, suggest	p подскажу, подскажешь
советоваться/по- (с +inst)	to consult (s.o.)	p советуюсь
претензия	claim
проезжать/проехать	to drive through or past	p проеду, проедешь
развивать/развить (+a)	to develop	p разовью, разовьёшь, past развил, развила, развило
разрушать/разрушить (+a)	to destroy, ruin
рассмотрение	examination, scrutiny
реветь/за-	to roar, howl	i реву, ревёшь
рекомендовать (i/p) (+a)	to recommend	рекомендую
риск	risk
рукопись (f)	manuscript
ручной	hand (adj); tame
рама	frame
сдаваться/сдаться	to surrender, give up	i сдаюсь, сдаёшься; p сдамся, сдашься, сдастся, сдадимся, сдадитесь, сдадутся, f past сдалась
скрытый	hidden
согласие	agreement
сходиться/сойтись	to meet; form a liaison with; agree	i схожусь, сходишься; p сойдёмся, past сошлись
солнышко	sun (dim)
страдание	suffering
сходство	similarity
сытый	replete, full	short forms сыт, сыта, сыты
убедительно	convincingly, earnestly
убийца (m/f)	murderer
удерживаться/удержаться	to stand firm; restrain os	p удержусь, удержишься
укреплять/укрепить (+a)	to strengthen	i укрепляю; p укреплю, укрепишь
уносить/унести (+a)	to carry away	i уношу, уносишь; p унесу, унесёшь, past унёс, унесла
упрямо	stubbornly
услуга	service, favour
храм	temple, church
частый	frequent
яйцо	egg	nom pl яйца, g pl яиц, d pl яйцам
блюдо	dish, course (of meal)
вероятность (f)	probability	по всей вероятности in all probability
ветерок	breeze
трудящийся	labouring  (participle)	трудящиеся the working people
мелодия	melody
посадка	boarding (of plane etc.); landing; planting	g pl посадок
сало	fat, lard
устраиваться/устроиться	to make arrangements; settle down; get a job; work out well
химия	chemistry
выть/за-	to howl	i вою, воешь
самостоятельность (f)	independence
старичок	(little) old man
тенденция	tendency
застой	stagnation
юбилей	jubilee, anniversary
административный	administrative
перчатка	glove (with fingers)	g pl перчаток
раздумье	meditation, thought
большевик	Bolshevik	g sg большевика
хозяйственный	economic
химический	chemical
таблица	table (of figures)
фашист	Fascist
лесной	forest (adj); forestry (adj)
металлический	metallic
резерв	reserve	иметь в резерве to have in reserve; экономические резервы economic reserves
винтовка	rifle	g pl винтовок
атом	atom
конструкция	construction
совхоз	state farm, sovkhoz
органический	organic
материя	matter
фундамент	foundation
частица	small part; particle
чертёж	technical drawing	g sg чертежа
строение	construction
сырьё	raw material(s)	no pl
гвардия	Guards
пакет	packet; bag (paper or plastic)
пистолет	pistol
социалистический	socialist
отряд	detachment (organized group of soldiers or workers)
палуба	deck (of a ship)
артиллерия	artillery
объединение	union, association
ядерный	nuclear
буржуазный	bourgeois
партизан	partisan
технологический	technological
физика	physics
научно-исследовательский	scientific-research (adj)	научно-исследовательский институт (НИИ) research institute
геолог	geologist
дрова (n) (pl)	firewood	g pl дров
итальянский	Italian (adj)
диктатура	dictatorship
машинный	machine (adj)
разведчик	secret agent; scout, prospector
академический	academic
отказывать/отказать (+d в +pr)	to refuse (s.o. sth)	p откажу, откажешь
сетка	net; string-bag	g pl сеток
сменяться/смениться	to be replaced	i сменяется; p сменюсь, сменишься
совестно (+d)	ashamed	Ему было совестно Не was ashamed
солома	straw
соперник	rival
таковой	such	как таковой as such
телеграф	telegraph
формирование	formation
юридический	legal, law (adj)
банка	jar, can	g pl банок; банка пива can of beer
авиация	aviation
актуальный	topical
аристократия	aristocracy
баржа	barge
батальон	battalion
башка (very coll)	head	no g pl
богатырь (m)	bogatyr, hero	g sg богатыря
ботинок	(low) boot	g pl ботинок
вагончик	small wagon, coach
промежуток	interval; space, gap	промежуток времени period of time
бетон	concrete
горящий	burning (adj)
диплом	diploma, degree
конституция	constitution
листва	foliage
медь (f)	copper (noun)
нету (+g)	there isn’t/aren’t (= нет) (coll)	Времени нету I’ve got no time
обыкновенно	usually
проволока	wire	колючая проволока barbed wire
путешественник	traveller
функция	function
агентство	agency
бульвар	avenue
газовый	gas (adj)	газовая плита gas stove
издатель (m)	publisher
кабы	if (coll)
кнопка	button, knob; drawing-pin	g pl кнопок
курица	hen	nom pl куры, g pl кур
веточка	twig, sprig	g pl веточек
взаимодействие	interaction
взволнованно	anxiously
вздох	sigh
влажный	damp
возиться (i) (с +inst)	to fiddle (with)	i вожусь, возишься
отводить/отвести (+a)	to take aside	i отвожу, отводишь; p отведу, отведёшь, past отвёл, отвела
вплотную (к)	close up (to)
всматриваться/всмотреться (в +a)	to look closely at
всячески	in every way possible
глазок	small eye; peephole
головка	small head	g пл головок
грамм	gram(me)	g pl граммов or (coll) грамм
грань (f)	border, verge; facet, edge
дар	gift	nom pl дары
дипломатический	diplomatic
дистанция	distance
доверять/доверить (+d)	to trust (s.o.); (+a +d) entrust (sth to s.o.)	i доверяю, доверяешь
донской	(of the river) Don
драма	drama
жених	fiancé	g sg жениха
жилой	dwelling (adj), residential	жилая площадь living space, accommodation
заворачивать/завернуть (+а)	to wrap; (за +а) turn (a corner)	p Она завернула за угол She turned the corner
заключённый	(as noun) prisoner, convict
заслуживать/заслужить	to merit, achieve by merit, deserve	p заслужу, заслужишь
затягивать/затянуть	to tighten	p затяну, затянешь
звёздочка	small star; asterisk	g pl звёздочек
идеологический	ideological
индустрия	industry
инструкция	instructions
карьера	career
князь (m)	prince	nom pl князья
ковш	scoop, ladle	g sg ковша
командирский	commander’s
конкурс	competition
кот	tomcat	g sg кота
ликвидировать (i/p)	to liquidate	ликвидирую
метро (indecl)	metro, underground
мрамор	marble
мужественный	manly, courageous
наверняка	for sure; safely, without taking risks
надолго	for a long time
насмешливо	mockingly, sarcastically
насыпь (f)	embankment
начальный	initial, primary
недра (pl)	depths, bowels (of the earth)	g pl недр
неприятно	(it’s) unpleasant; unpleasantly
няня	nurse	g pl нянь
обучение (+d)	teaching (of sth); training (in sth)	обучение грамоте teaching of literacy
обходить/обойти (+a)	to go round; avoid	i обхожу, обходишь; p обойду, обойдёшь, past обошёл, обошла
опаздывать/опоздать (на +a)	to be late (for)
оросительный	irrigation (adj)
отличать/отличить (+a)	to distinguish
паспорт	passport	nom pl паспорта
пачка	packet, pack	g pl пачек
пашня	ploughed field	g pl пашен
пёс	dog (coll)	g sg пса
плановый	planned, planning
плоскость (f)	flatness; plane (surface)
по-вашему	in your opinion; as you want	Пусть будет по-вашему Have it your own way
подбородок	chin
подвода	cart
кланяться/поклониться	to bow	i кланяюсь; p поклонюсь, поклонишься
поперечный	transverse
популярный	popular
последовательно	consistently
посмеиваться (i)	to chuckle
предусматривать/предусмотреть	to envisage, stipulate, foresee	p предусмотрю, предусмотришь
преобразование	transformation; reform
протестовать/за- (против +g)	to protest (against)	i протестую
противоположный	opposite; contrary
радиостанция	radio station
разделение	division
размышлять/размыслить (о +pr)	to ponder (on)	i размышляю
рай	paradise	pr sg в раю
расширять/расширить (+a)	to broaden, expand	i расширяю
редкость (f)	rarity
родня	relatives
ручей	brook, stream	g sg ручья, g pl ручьёв
сводиться/свестись (к +d)	to reduce (to)	i сводится
серебро	silver
сказываться/сказаться	to have an effect (на +pr) on; proclaim oneself	p скажется
слесарь (m)	metal worker, fitter	nom pl слесаря
сменять/сменить (+a)	to replace, change	i сменяю; p сменю, сменишь
сниться/при-	to appear in a dream, see in a dream	i Мне снилось, что ... I dreamt that…; p Она мне приснилась I dreamt about her
ссылка	internal exile (inside Russia)
соседство	vicinity	жить по соседству to live nearby
сосна	pine-tree	nom pl сосны, g pl сосен
стесняться/по-	to be shy	i стесняюсь; He стесняйся Don’t be shy
судебный	judicial, legal
торжество	celebration; triumph
угнетение	oppression
уговаривать/уговорить (+a)	to persuade, urge
узор	pattern
украинский	Ukrainian
уникальный	unique
уставляться/уставиться (в +a)	to fix one’s gaze (on), stare (at)	p уставлюсь, уставишься
устойчивый	stable
численность (f)	total number, quantity
шарик	(small) ball
эксперимент	experiment
энергетический	power, energy (adj)	энергетические ресурсы energy resources
этакий	such (= такой) (coll)
японец	Japanese man
весить (i)	to weigh (intrans)	i вешу, весишь; Сколько это весит? How much does this weigh?
жидкий	liquid; thin, feeble
матушка	mother (coll)
парадный	ceremonial; main	парадная дверь front door
построение	construction
разбойник	brigand
ребятишки	children, kids (coll)	g pl ребятишек
статуя	statue
тракторный	tractor (adj)
азиатский	Asian (adj)
ансамбль (m)	ensemble
близнец	twin	g sg близнеца
владение	possession, ownership
земледeлец	farmer, peasant farmer	g sg земледельца
бровь (f)	eyebrow; brow	g pl бровей
правящий	ruling (adj)	правящая верхушка ruling clique
расположение	arrangement; location; liking; inclination
рельс	rail	сойти с рельсов to go off the rails
реформа	reform
речной	river (adj)
руль (m)	steering-wheel; helm	g sg руля
степной	steppe (adj)
сынок	sonny (form of address)
теплота	warmth
трение	friction
тундра	tundra (treeless northern wastes)
установление	establishment
языковой	linguistic
яркость (f)	brightness
амбар	barn; storehouse
аспирант	postgraduate (noun)
бабий	women’s (coll; sexist)	f бабья, n бабье
бесплодный	barren; fruitless
ворчать (i)	to grumble; growl	ворчу, ворчишь
диаметр	diameter
дореволюционный	pre-revolutionary
каторга	hard labour, penal servitude
компас	compass
лечение	healing, treatment
мерзавец	scoundrel (coll)
набережная (f) (adj)	embankment; sea-front
накопление	accumulation
оглядывать/оглянуть (+a)	to inspect, look over
парадокс	paradox
видать/по- (+a)	to see (coll)	no pres
приподнимать/приподнять (+a)	to raise slightly	p приподниму, приподнимешь, past приподнял, приподняла, приподняло
разорение	ruin, devastation
исполком	executive committee
баланс	balance (econ)
стеклянный	glass (adj)
старшина (m)	sergeant-major; leader	nom pl старшины
полковник	colonel
глина	clay
производительный	productive
гимназия	grammar school, high school
пуговица	button
комбинат	combine, industrial complex
сундук	trunk, chest	су́ндук; g sg сундука́
мельница	mill
тракторист	tractor driver
букет	bouquet
окоп	trench
сезон	season
паровоз	locomotive, steam engine
юбилейный	anniversary (adj)
ось (f)	axis; axle	g pl осей
арестованный	arrested, person arrested
валенок	felt boot	g pl валенок
животноводство	stock-raising
стрельба	shooting
выработка	working-out; production
гонка	race	g pl гонок
заводской	factory (adj)
прислуга	servants	no pl
разряд	discharge; category	первого разряда first class
вдова	widow	nom pl вдовы
последовательный	consistent; successive
психологический	psychological
пуд	pood (16.38 kg)	nom pl пуды
цилиндр	cylinder; top hat
француз	Frenchman
лейтенант	lieutenant
агрегат	unit, assembly
калитка	gate, garden gate	nom pl калиток
отверстие	opening, aperture
пленум	plenary session
комплексный	complex, consisting of several parts
машинист	engine-driver
мамаша	mother (coll)
лунный	lunar
приказание	order, command
благосостояние	well-being, prosperity
комплекс	complex
рота	company (of soldiers)
областной	oblast (adj), provincial
офицерский	officer’s
новогодний	new year (adj)
ведомство	department (of government)
композитор	composer
конструктор	constructor, designer
пианино (indecl)	(upright) piano	(indecl)
воробей	sparrow	g sg воробья, g pl воробьёв
плакат	poster
пробка	cork; plug; fuse; traffic jam	g pl пробок
производиться/произвестись	to be produced	i производится
благополучно	safely, well
качественный	qualitative; good quality
космический	(outer) space	космический корабль spaceship
пучок	bundle; bun (hairdo)
себестоимость (f)	cost, cost price
разложение	decomposition, disintegration
револьвер	revolver
ток	electric current
ферма	farm
шахта	mine, pit
наружный	outer, external
братство	brotherhood
деление	division
ликвидация	liquidation, elimination
изготовлять/изготовить (+a)	to manufacture	i изготовляю; p изготовлю, изготовишь
плавание	swimming; sailing
сени (pl)	entrance hall (of peasant hut)	g pl сеней
сенатор	senator
первичный	primary
шашка	sabre; (pl) draughts, checkers (board game)	g pl шашек
оболочка	cover, envelope	g pl оболочек
погон	shoulder-strap
посев	sowing
снабжение	supply, supplying
господствующий	ruling, predominant
командующий (+inst)	(as noun) commander (of)	командующий армией commander of the army
польский	Polish (adj)
груша	pear
жила	vein
стадо	herd
барыня	lady
водяной	water (adj), aquatic, water-powered	водяная мельница watermill
идиот	idiot
интеллигент	member of intelligentsia; professional; intellectual
кладбище	cemetery
нагибаться/нагнуться	to bend down
грузить/по- (+a)	to load	i гружу, грузишь; за-/по- р; p погружу́, погру́зишь
погружать/погрузить	to immerse	p погружу́, погрузи́шь
смесь (f)	mixture
уличный	street (adj)
впредь	henceforth, in future
свёрток	package, bundle
содержаться (i)	to be maintained; be contained	i содержусь, содержишься
равновесие	balance, equilibrium
хата	peasant house
экипаж	carriage; crew
овраг	ravine, gully
фуражка	peaked cap	g pl фуражек
бухта	bay
козёл	goat	g sg козла
якорь (m)	anchor	nom pl якоря
комбайн	combine harvester
сани (pl)	sledge	g pl саней
император	emperor
полярный	polar
рояль (m)	(grand) piano
земледелие	agriculture
должный	due, proper	должным образом properly
песчаный	sandy
пехота	infantry
залив	bay
путёвка	voucher for travel and accommodation	g pl путёвок
сплочение	uniting, strengthening
выпускник	final-year student; graduate; school-leaver	g sg выпускника
механизация	mechanization
механизатор	mechanization expert; machine servicer
госпиталь (m)	(military) hospital
конгресс	congress
рубка	felling; chopping; deck cabin	g pl рубок
огурец	cucumber
посол	ambassador
ветеран	veteran
воинский	military
порошок	powder
удобрение	fertilizer; fertilizing
аппаратура	apparatus
батька (m)	dad, father (coll)
паренёк	lad (coll)	g sg паренька
декрет	decree	в декрете (coll) on maternity leave
плотина	dam
проговорить (р)	to say
ранг	rank
безумие	madness
бессмертие	immortality
центнер	100 kilogrammes, centner
идеология	ideology
ядро	nucleus; ball	nom pl ядра, g pl ядер
питательный	nourishing
корма	stern (of ship)
окраска	colouring
архитектура	architecture
зрительный	visual
турнир	tournament
причал	mooring
тратить/по- (+a)	to spend	i трачу, тратишь; по-/ис- р
шторм	gale
корешок	back (of bookbinding); small root; counterfoil; (coll) pal, mate
мина	mine, shell (mil)
рюмка	wineglass	g pl рюмок
крючок	hook
химик	chemist
ваза	vase
зародыш	foetus; embryo
сотрудничество	collaboration
жидкость (f)	liquid
физик	physicist
спортсмен	sportsman
архитектурный	architectural
покров	cover, shroud	снежный покров blanket of snow
коллекция	collection
миролюбивый	peace-loving
пленный (m) (adj)	captive
теплоход	motor-vessel, motor-ship
алмазный	diamond (adj)
космос	cosmos, space
скоростной	high-speed, express
автоматизация	automation
вулкан	volcano
выше	higher, above
старец	elder
адмирал	admiral
охлаждение	cooling
социалист	socialist
минус	minus; disadvantage
видение	vision
лыжи (pl)	skis	g pl лыж
сборный	collapsible, prefabricated; mixed, combined (team)
кислород	oxygen
пещера	cave
общечеловеческий	universal, of all mankind
каюта	cabin (ship)
пузырёк	bubble; phial
равнина	plain
девчата (pl)	girls (coll)	no sg, g pl девчат
продолжительный	prolonged
водохранилище	reservoir
воздействие	influence, pressure
заповедник	reserve, nature-reserve
чемпионат	championship
сердитый	angry
тулуп	sheepskin coat
активность (f)	activity
анализировать/про- (+a)	to analyse	i анализирую
аплодировать/за- (+d)	to applaud (s.o. or sth)	аплодирую
ассортимент	assortment
барабан	drum
боковой	side (adj)	боковой карман side pocket
болтать/по-	to shake, stir; (coll) chatter
варить/за- (+a)	to boil, cook by boiling	i варю, варишь
влиять/по- (на +a)	to influence	i влияю, влияешь
влюблённый (в +a)	in love (with)
внимательный (к)	attentive, considerate (to)
водитель (m)	driver
водить/по- (+a)	to lead, (p) to lead about	i вожу, водишь
возвращаться/возвратиться	to return	p возвращусь, возвратишься
возрастающий	growing, increasing
вполголоса	in an undertone
выражаться/выразиться	to express os; (coll) swear	p выражусь, выразишься
грешный	sinful
дача	dacha, holiday cottage	Они на даче They’re at their country cottage
двойной	double, twofold	двойной подбородок double chin
диск	disk; discus
днём	by day; in the afternoon
доброволец	volunteer	g sg добровольца
догадка	guess, conjecture	g pl догадок
допрос	interrogation
древесный	wood (adj)
живопись (f)	painting, paintings	no pl
завершать/завершить (+a)	to complete
заманчивый	tempting
заросль (f)	thicket
заряд	charge, cartridge
здравоохранение	healthcare, health service
казнь (f)	execution
капитальный	main, most important
картофель (m)	potatoes	no pl
кирпичный	brick (adj)
клад	treasure
компьютер	computer
конный	horse (adj), equestrian
коричневый	brown
купол	cupola	nom pl купола
лавочка	small shop; small bench	g pl лавочек
лад	harmony, tune; manner	pr sg в ладу́, nom pl лады́; петь в лад to sing in tune; на свой лад in one’s own way
лечить/вы- (+a)	to treat, cure	i лечу, лечишь
миллиметр	millimetre
младенец	baby
намёк	hint, allusion
напевать/напеть	to sing; sing quietly, hum
насквозь	through	Она промокла насквозь She got wet through
небрежно	carelessly
неизбежность (f)	inevitability
нелёгкий	difficult; heavy
нелепый	absurd
необычайный	exceptional
неожиданность (f)	surprise
неплохой	not bad
нетерпеливо	impatiently
нефтяной	oil (adj)	нефтяная промышленность oil industry
обижать/обидеть (+a)	to offend, hurt	p обижу, обидишь
обнаруживаться/обнаружиться	to be revealed
обрыв	precipice
одиночество	loneliness, solitude
одобрять/одобрить (+a)	to approve	i одобряю
опасно	dangerously
опера	opera
опрокидывать/опрокинуть (+a)	to knock over, overturn
орошение	irrigation
отбрасывать/отбросить (+a)	to throw off; discard	p отброшу, отбросишь
откос	slope
охотничий	hunting (adj)	f охотничья, n охотничье
палата	chamber; ward
палач	executioner	g sg палача́
палочка	small stick, baton	g pl палочек
парижский	Parisian
пейзаж	landscape
перегрузка	overload	g pl перегрузок
переплёт	binding
подвергать/подвергнуть (+a +d)	to subject (s.o. to sth)	p past подверг, подвергла
подряд	in succession; contract	три дня подряд three days running
пожелание	wish	наилучшие пожелания best wishes
покойник	dead person, the deceased
по-разному	in different ways
по-своему	in one’s own way
потребитель (m)	consumer
почин	initiative
приближаться/приблизиться (к +d)	to approach; draw near	p приближусь. приблизишься
признаваться/признаться (в +pr)	to confess	i признаюсь, признаёшься; p признаюсь, признаешься
принципиальный	of principle, fundamental	принципиальный вопрос question of principle
провод	wire	nom pl провода
прожектор	searchlight; floodlight	nom pl прожектора
простота	simplicity
прочно	solidly
прошедший	past (adj)
пузырь (m)	bubble	g sg пузыря
разгром	crushing defeat; devastation
разоблачать/разоблачить (+a)	to expose, unmask
разом	at once, at one go; in a flash (coll)
разрывать/разорвать (+a)	to tear up	p разорву, разорвёшь, f past разорвала
распространять/распространить (+a)	to spread	i распространяю
рассеянный	absent-minded
ремень (m)	belt	рем(е)нь; g sg ремня
робко	timidly
свист	whistling
свойственный (+d)	characteristic (of)
сдерживать/сдержать (+a)	to hold back, restrain, keep (promise)	p сдержу, сдержишь
сев	sowing
скандал	scandal
сломить (р) (+a)	to break	p сломлю, сломишь
случайность (f)	chance, chance occurrence
собачий	dog’s	f собачья, n собачье; собачья жизнь a dog’s life
советник	adviser
согласно (+d)	according to
сокращать/сократить (+a)	to shorten; reduce	p сокращу, сократишь
солидный	solid, sound; reliable
спокойствие	calmness
сражение	battle
стадион	stadium	на стадионе at/in a stadium
стан	figure (human); camp
стойкость (f)	firmness, steadfastness
стремительный	rapid; dynamic
таить (i) (+a)	to conceal
таскать/по- (+a)	to drag
татарин	Tatar	nom pl татары, g pl татар
ужинать/по-	to have supper
употреблять/употребить (+a)	to use	i употребляю
усиление	strengthening
устранять/устранить (+a)	to remove
фу	(expressing disgust) ugh!
чудовищный	monstrous
чуждый	(+d) alien (to); (+g) devoid (of)	short forms чужд, чужда, чужды
шоссе (n) (indecl)	highway
шумный	noisy
эра	era
эффективный	effective
ясность (f)	clarity
адвокат	lawyer
активист	(political) activist
архитектор	architect
бал	ball (dance)	pr sg на балу́, nom pl балы́
беднота	the poor
блокнот	notepad
валиться/по-/с-	to fall	i валюсь, валишься; по-/с- р
ввиду (+g)	in view of
веко	eyelid	nom pl веки, g pl век
весной	in spring
вешалка	coat hanger	g pl вешалок
вздрагивать/вздрогнуть	to start, flinch, shudder
внук	grandson
вопреки (+d)	in spite of
вор	thief	nom pl во́ры, g pl воро́в
ворот	collar; winch
вот-вот	just about to, on the point of	Она вот-вот придёт She’ll be here any moment
быть вправе (+inf)	to have a right to
вспоминаться (i)	to be remembered	Вспоминается ... I remember...
встречный	oncoming	встречный ветер head wind
выращивать/вырастить (+a)	to grow (sth), rear, cultivate	p выращу, вырастишь
глухо	indistinctly
господствовать (i) (над +inst)	to dominate	господствую
гребень (m)	comb, crest
даль (f)	distance	pr sg в дали
дворник	caretaker, janitor; (coll) windscreen wiper
деревенский	village, country (adj)
длиться (i)	to last
жалость (f)	pity
жёсткий	harsh
заблуждение	delusion
загадочный	mysterious
заговор	plot
загораться/загореться	to catch fire	p загорится
задумчивый	thoughtful
залезать/залезть (в/на +a)	to climb, get (into/onto)	p залезу, залезешь, past залез, залезла
заодно	together; (coll) at the same time
заполнять/заполнить (+a)	to fill in, fill up	i заполняю; заполнять бланк to fill in а form
заработок	earnings
заслуженный	deserved; distinguished
зимой	in winter
злоба	spite, malice
извлекать/извлечь (+a)	to extract	p извлеку, извлечёшь, извлекут, past извлёк, извлекла
излишний	superfluous
изобилие	abundance
икона	icon
индивидуальный	individual
индустриальный	industrial
исключать/исключить (+a)	to exclude
каникулы (f) (pl)	holidays, vacation	g pl каникул
капелька	droplet	g pl капелек
кидаться/кинуться	to throw os, rush
кое-где	here and there
количественный	quantitative
комендант	warden (of hostel); commandant, governor
конфликт	conflict
контакт	contact
корка	crust; rind	g pl корок
корреспонденция	correspondence
летом	in summer
максимальный	maximal
машиностроение	mechanical engineering
местность (f)	locality, district
мундир	uniform
набирать/набрать (+a)	to gather, assemble	p наберу, наберёшь, f past набрала
накапливать/накопить (+a)	to accumulate	p накоплю, накопишь
налетать/налететь (на +a)	to swoop on; run into	p налечу, налетишь
наряд	attire, costume; order, warrant
настойчивый	insistent
находка	find	g pl находок
неоднократно	repeatedly
нервничать (i)	to be nervous
нисколько	not at all
обидно	it hurts, it’s annoying	Ему обидно видеть это It hurts him to see that
овладение (+inst)	mastery (of)
ограничиваться/ограничиться (+inst)	to limit oneself (to); be limited (to)
орех	nut
отделять/отделить (+a)	to separate	i отделяю; p отделю, отделишь
отпирать/отпереть (+a)	to unlock	p отопру, отопрёшь, past отпер, отперла, отперло
отправление	dispatch; departure (of train)
ощущать/ощутить (+a)	to feel, sense	p ощущу, ощутишь
паника	panic
пахать (i) (+a)	to plough	i пашу, пашешь
первенство	first place (in competition); championship
пласт	layer; stratum	g sg пласта́
плетень (m)	hurdle, wattle (fence)
плотник	carpenter
поближе	a bit closer
подчинение	submission, subjection
пожарный	fire (adj); (as noun) fireman
поклон	bow (greeting)
поляна	glade, clearing, forest meadow
порождать/породить (+a)	to beget, engender, generate	p порожу, породишь
поскорее	a little faster; hurry up!
посматривать (i) (на +a)	to look (at) from time to time
почитать (i/p) (+a)	i: to respect; p: to read a little
поэма	long poem
презрение	scorn
преимущественно	primarily
приспособление	adaptation; device
приход	arrival
проверка	check(ing), inspection	g pl проверок
пролетать/пролететь	to fly through or past	p пролечу, пролетишь
просыпаться/проснуться	to wake up
рассыпаться	to scatter; crumble	i/p рассыпа́ться/рассы́паться; p рассы́плется
растворяться/раствориться	to dissolve; to open	i растворяется
теряться/рас-	to get lost; panic	p растеряюсь
реальность (f)	reality
рекорд	record
речка	small river	g pl речек
руководствоваться (i) (+inst)	to be guided (by)	руководствуюсь
сбор	collection, gathering	Все в сборе Everyone is here
сводка	report, bulletin	g pl сводок
сдача	handing over; change (money returned)
семьдесят	seventy	g семидесяти
сено	hay
сердечный	heart (adj); heartfelt; warm-hearted
ситуация	situation
сияние	radiance
скважина	chink, hole
ломать/с- (+a)	to break, fracture
составной	composite; component	составная часть component part, component
ссылаться/сослаться (на +a)	to refer to, quote; plead (give as an excuse)	p сошлюсь, сошлёшься
твёрдость (f)	firmness
тетрадка	exercise book	g pl тетрадок
тираж	number of copies; draw (lottery)	g sg тиража́
торжественно	ceremonially; festively
тощий	emaciated
треск	crack; crash
трещина	crack, cleft
труп	corpse
украшать/украсить (+a)	to adorn	p украшу, украсишь
упорно	persistently
фокус	focus; trick
формула	formula
футбольный	football (adj)
хлебный	bread (adj)
хло́пок	cotton	хло́п(о)к
хлопо́к	clap, bang	хлоп(о́)к
цикл	cycle
экспериментальный	experimental
анархия	anarchy
банда	band, gang
бетонный	concrete (adj)
бремя (n)	burden	g sg бремени, no pl
вертеться (i)	to rotate	i верчусь, вертишься
виноват	guilty; sorry! (short adj)	Она не виновата It’s not her fault
вольно	freely
восемнадцать	eighteen
вредно	harmful
выдержка	self-control; excerpt	g pl выдержек
вынужденный	forced
галстук	tie, necktie
географический	geographical
гитара	guitar
глиняный	clay (adj)
горка	hillock	g pl горок
дверца	small door, car door	g pl дверец
девяносто	ninety	g, d, inst, pr девяноста
демонстрация	demonstration
достояние	property
драгоценность (f)	jewel; something valuable
дрогнуть (р)	to shake, waver	no i
дрогнуть/про-	to be chilled
дружок	friend (coll)
ёлка	fir tree	g pl ёлок
ерунда	nonsense; trifling matter (coll)
жечь/с- (+a)	to burn	i жгу, жжёшь, жгут, past жёг, жгла
завершение	completion
зависть (f)	envy
завязывать/завязать (+a)	to tie; start, get involved in	p завяжу, завяжешь
задыхаться/задохнуться	to suffocate
заезжать/заехать	to call in	p заеду, заедешь
заключительный	final, concluding
законодательство	legislation
заливать/залить (+a +inst)	to flood (sth with sth)	p залью, зальёшь, f past залила
заносить/занести (+a)	to bring in; raise	i заношу, заносишь; p занесу, занесёшь, past занёс, занесла
запрещать/запретить	(+d) to forbid (s.o.); (+a) ban (sth)	p запрещу, запретишь
зрелище	spectacle
иголка	needle	g pl иголок
избавляться/избавиться (от +g)	to escape from; get rid of	p избавлюсь, избавишься
изложение	exposition
исследовать (i/p) (+a)	to investigate	исследую
историк	historian
касса	cash desk; ticket-office
клин	wedge	nom pl клинья, g pl клиньев
когда-либо	at any time; ever
контрольный	checking, monitoring
крохотный	tiny (coll)
купеческий	merchant (adj)
манёвр	manoeuvre
математика	mathematics
медицина	medicine, medical studies
мобилизовать (i/p) (+a)	to mobilize	мобилизую
набор	set, collection; recruitment
наглядно	clearly, graphically
налаживать/наладить (+a)	to put in working order, set going, adjust, put in order	p налажу, наладишь
хмуриться/на-	to frown
национальность (f)	nationality, ethnic group
недоумение	bewilderment
неловкий	awkward
непримиримый	irreconcilable; uncompromising
овощи (m) (pl)	vegetables	g pl овощей
ограда	fence
определённо	definitely
оригинальный	original
осуществляться/осуществиться	to be brought about, be fulfilled, be put into effect	i осуществляется
отстаивать/отстоять (+a)	to defend	p отстою, отстоишь
отцовский	paternal
переменять/переменить (+a)	to change; transform	p переменю, переменишь
перила (pl)	handrail, banisters	g pl перил
печально	sad(ly)
вредить/по- (+d)	to harm, damage	p поврежу, повредишь
позор	disgrace
полезно	(it is) useful; usefully
поляк	Pole
порыв	gust; impulse
предназначать/предназначить (на +a/для +g)	to intend for, earmark (for)
предпочитать (i) (+a +d)	to prefer sth to sth
прекращаться/прекратиться	to cease	p прекратится
преодоление	overcoming
преподаватель (m)	teacher, lecturer
приглашение	invitation
прикосновение	contact
присоединяться/присоединиться (к +d)	to join, join (a group)	i присоединяюсь
проделывать/проделать (+a)	to make, do, accomplish
профиль (m)	profile
прыжок	jump
равняться/с-	(на +a) to emulate; (+d) be equal to	i равняюсь
развёртываться/развернуться	to unroll, unfold; expand; swing round (make a U-turn)	развёртываться i/разворачиваться i
разрез	cut, section	в разрезе +g (coll) in the context of
разъяснять/разъяснить (+a)	to explain	i разъясняю
располагаться/расположиться	to take up position; settle oneself; make os comfortable	p расположусь, расположишься
расширяться/расшириться	to broaden, expand	i расширяется
режиссёр	producer (theatre), director (cinema)
религиозный	religious
робкий	timid
рухнуть (р)	to collapse
самостоятельно	independently
связанный	connected; bound
сделка	deal, transaction	g pl сделок; заключить сделку to do a deal
скучать (i)	to be bored; (по +d) miss (s.o. or sth)
соблюдать/соблюсти (+a)	to keep to, adhere to
совпадать/совпасть (с +inst)	to coincide (with)
сознавать/сознать (+a)	to acknowledge, be aware of	i сознаю, сознаёшь
соскакивать/соскочить (с +g)	to jump off	p соскочу, соскочишь
состязание	competition
стойка	bar, counter; stance	g pl стоек
стрелка	arrow; hand (of clock)	g pl стрелок
струна	string (of instrument)	струна́; nom pl стру́ны
супруга	spouse (wife)
сходный	similar; (coll) fair (of price)
тревожный	worrying; worried
туго	tight(ly); difficult, hardly
убеждённый	convinced
угрюмый	sullen, gloomy
упрекать/упрекнуть (+a в +pr)	to accuse (s.o. of), reproach
усердно	conscientiously
устало	wearily
ух	ooh!
филиал	branch (of organization)
холодильник	refrigerator
худо	bad, badly
цепляться/за- (за +a)	to clutch (at); catch (on)	i цепляюсь
частота	frequency	частота́; nom pl часто́ты
чердак	attic	g sg чердака
чётко	clearly, distinctly, precisely
швырять/швырнуть (+a or +inst)	to fling, hurl, throw (coll)	i швыряю
шевелить/по- (+a or +inst)	to stir, move	p: по-/шевельнуть
шёлковый	silk (adj)
шерсть (f)	wool; hair (of animal)	кошачья шерсть cat fur
экскурсия	excursion
юбка	skirt	g pl юбок
ястреб	hawk	я́стреб; nom pl ястреба́
авангард	vanguard
архив	archive(s)
ахать/ахнуть	to gasp
бесспорный	indisputable
бешено	madly, furiously
былой	former, past	былое величие former greatness
вводиться/ввестись	to be introduced, brought in	i вводится
великолепно	splendid(ly)
взвод	platoon	на взводе drunk; agitated
видимость (f)	visibility; appearance
висок	temple (ear to forehead)
вкладывать/вложить (+a)	to insert; invest	p вложу, вложишь
вкусный	tasty
выбегать/выбежать (из +g)	to run out	p выбегу, выбежишь, выбегут
вымысел	fabrication, fantasy
гад	swine, rat (of person) (coll)
горючее (n) (adj)	fuel
грамотный	literate
граната	shell; grenade
греметь/за-	to roar, resound	i гремлю, гремишь
греть/по- (+a)	to heat	i грею, греешь
дискуссия	discussion
дичь (f)	game, wildfowl
дрожащий	trembling
ей-богу	truly, indeed (coll)
желудок	stomach
забивать/забить (+a)	to begin to beat; hammer in; block; cram	p забью, забьёшь; бить i/забивать i
задевать/задеть (+a)	to touch; catch (on sth)	p задену, заденешь
замечательно	remarkable; remarkably
записной	note (adj)	записная книжка notebook
засуха	drought
затруднение	difficulty
значок	badge
избыток	abundance; surplus
изобретать/изобрести (+a)	to invent	p изобрету, изобретёшь, past изобрёл, изобрела
изумительный	amazing
изящный	elegant
исход	outcome, end
календарь (m)	calendar	g sg календаря
карточка	card	g pl карточек
клясться/по-	to swear, vow	i клянусь, клянёшься, past клялся, клялась
коалиция	coalition
комментарий	commentary
котелок	pot; bowler hat
круто	steeply; sharply
латинский	Latin (adj)
литься/по-	to pour	i льётся, past лился, лилась
лихой	dashing, daring; skilful (coll)
маска	mask	g pl масок
мел	chalk; whitewash
мировоззрение	outlook, philosophy of life
мучить/за-/из- (+a)	to torment	за-, из- p
мяч	ball (for games)	g sg мяча́
наедине	in private; alone
наибольший	largest
намечаться/наметиться	to be planned
насмешка	taunt	g pl насмешек
недовольный (+inst)	dissatisfied (with)
неизменно	invariably
немедленный	immediate
необыкновенно	unusually
непонятно	incomprehensible/ly
нетерпение	impatience
неудача	failure
обозначать/обозначить (+a)	to mark, designate, denote, mean
оглядывать/оглядеть (+a)	to look over, inspect	p огляжу, оглядишь
ограничивать/ограничить (+a)	to limit
одобрение	approval
ознакомляться/ознакомиться (с +inst)	to acquaint oneself with	p ознакомлюсь, ознакомишься
осуждать/осудить (+a)	to condemn	p осужу, осудишь
отбивать/отбить (+a)	to repulse; remove; break off; beat off, get by force	p отобью, отобьёшь
отважный	courageous
палатка	tent	g pl палаток
пена	foam
первобытный	primitive
переживание	experience, emotional experience
петля	loop; hinge	g pl петель
платформа	platform
плодородный	fertile, fruitful
поверх (+g)	above
повседневный	everyday
подвёртываться/подвернуться	(coll) to turn up, crop up; be rolled up; be sprained, twisted (foot)
делиться/по- (+inst c +inst)	to share (sth with s.o.)	p поделюсь, поделишься
подлый	mean, underhand
подполье	underground organization; cellar	уйти в подполье to go underground
подражать (i) (+d)	to imitate
покачиваться (i)	to rock, sway
покоиться (i) (на +pr)	to rest, repose (on)	-	4
покупка	purchase	g pl покупок	6
полночь	midnight	g полуночи	6
помещаться/поместиться	to be located; find space, go in, fit in; install os	i помещусь, поместишься	7
порок	vice; defect	-	8
портить/ис-	to spoil, damage	i порчу, портишь; p испорчу, испортишь	8
посещение (+g)	visit (to), attendance (at)	-	9
посредством (+g)	by means of	-	9
посылка	parcel; errand; sending	g pl посылок	10
предлог	pretext; preposition	-	11
представляться/представиться	to introduce os; present itself, occur	p представлюсь, представишься	11
прерывать/прервать (+a)	to interrupt	p прерву, прервёшь	12
привязывать/привязать (+a к +d)	to attach (sth to sth)	p привяжу, привяжешь	12
приёмник	radio set	-	12
проза	prose	-	13
прокладывать/проложить (+a)	to lay, construct (a road)	p проложу, проложишь	14
прощальный	farewell (adj), parting	-	14
психология	psychology	-	14
путешествовать/по-	to travel	i путешествую	15
пятница	Friday	-	15
разглядеть (р) (+a)	to make out, perceive	p разгляжу, разглядишь; no i	16
раздел	division; section	-	16
разыскивать/разыскать (+a)	to seek out, search for	p разыщу, разыщешь	17
раскалённый	scorching, burning hot	-	19
распространённый	widespread, common	-	19
рассеивать/рассеять (+a)	to scatter	p рассею, рассеешь	19
таять/рас-	to melt	i таю, таешь	19
растерянный	perplexed, bewildered	-	20
ревновать (i)	to be jealous	i ревную	21
репутация	reputation	-	21
рисовать/на- (+a)	to draw	i рисую; p нарисую	21
селение	settlement, village	-	21
силуэт	silhouette	-	22
синева	blue colour, blueness	-	22
скидывать/скинуть (+a)	to throw off (coll)	-	22
складка	fold, crease	g pl складок	22
склонный (к +d or +inf)	inclined (to)	short forms: склонен, склонна, склонны	23
слезать/слезть (с +g)	to climb down, climb off	p слезу, слезешь, past слез, слезла	23
совместно	jointly	-	23
содружество	commonwealth	-	23
стихия	element, elemental force; chaos	-	23
студенческий	student (adj)	-	24
стыдиться/по- (+g)	to be ashamed of	i стыжусь, стыдишься	27
сумка	bag, handbag	g pl сумок	27
сурово	severely	-	27
схватка	fight, tussle	g pl схваток; схватки (muscle) contractions	29
темнеть/по-	to get dark, go dark	i темнеет; по-/с- р	29
тётка	aunt; (coll) woman	g pl тёток	30
техник	technician	-	30
тоненький	slim	-	30
топить/по- (+a)	to stoke; heat; (p) sink (sth), drown (s.o.)	i топлю, топишь; p по-/y-	31
трижды	thrice, three times	-	31
трубочка	small pipe, tube	g pl трубочек	32
трус	coward	-	32
трясти/по- (+a)	to shake	i трясу, трясёшь, past тряс, трясла	32	itt
удаляться/удалиться	to move away, withdraw	i удаляюсь	33
уделять/уделить (+a +d)	to allot, give	i уделяю; уделять внимание +d to give/pay attention to sth	34
узелок	small knot; small bundle	-	35
указанный	indicated, specified	-	35
украшение	decoration	-	35
уменьшаться/уменьшиться	to diminish, decrease	-	36
умница (m/f)	clever person (coll)	(m/f)	37
унылый	sad, cheerless	-	37
упрёк	reproach	-	37
усиливать/усилить (+a)	to strengthen	-	37
усталый	tired	-	38
утка	duck; hoax	g pl уток	38
факультет	faculty	на юридическом факультете in the law faculty	38
целоваться/по-	to kiss (each other)	i целуются	40
шутливо	jokingly, facetiously	-	44
электричество	electricity	-	45
яблоня	apple-tree	g pl яблонь	45
абстрактный	abstract	-	45
агитация	agitation	-	46
администрация	administration	-	47
аккуратный	exact, punctual; tidy	-	44
армянский	Armenian (adj)	-	32
бережно	carefully	-	24
бродяга (m)	tramp, down-and-out	(m)	20
великан	giant	-	20
венгерский	Hungarian	-	48
вложение	enclosure (in letter); investment
возникновение	beginning, origin
волшебный	magic
враждебный	hostile
вред	harm	g sg вреда́
выборы (m pl)	election	(m pl) g pl выборов
гадость (f)	filth; dirty trick	(f)
геологический	geological
гимнастёрка	soldier’s tunic	g pl гимнастёрок
гнёт	oppression
граф	count (title)
график	graph; schedule
грош	half-kopeck, farthing	g sg гроша́; без гроша penniless
губерния	tsarist province (now область)
демократ	democrat
дорожный	road (adj)
духовенство	clergy
едкий	acrid, pungent; sarcastic
жадно	greedily
жилище	dwelling, habitation
заветный	cherished, intimate	заветная цель cherished goal; заветная мечта secret dream
замена	replacement
заново	anew
западноевропейский	Western European
запевать/запеть	to start singing	p запою, запоёшь
затрачивать/затратить (+a)	to spend, expend	p затрачу, затратишь
звонкий	ringing, clear
знаток	expert	g sg знатока́
ирония	irony
исповедь (f)	confession	(f)
кожаный	leather (adj)
колония	colony
конский	horse (adj)	конский завод stud farm
конфета	sweet
кружиться/за-	to whirl, spin round; begin to spin	i кружусь, кружишься
кто-либо	anyone
купаться/ис-	to bathe
кучка	small heap; small group	g pl кучек
лапа	paw
липа	lime tree
ловушка	trap	g pl ловушек
лопаться/лопнуть	to burst
любопытно	curiously
материк	mainland	g sg материка́
мгновенно	instantaneously, instantly
метель (f)	snowstorm	(f)
мостовая (f)	roadway	(f)
мышка	armpit; mouse	g pl мышек; под мышкой under one’s arm
наводить/навести (+a)	to guide (to); evoke, cause	p наведу, наведёшь, past навёл, навела; навести порядок to put things in order
налог	tax
напряжённость (f)	tension	(f)
национализм	nationalism
неверно	false(ly)
негодяй	rascal
недаром	not for nothing
недоверие	mistrust
некто	someone, a certain	некто Сидоров a certain Mr Sidorov
ненужный	unnecessary
непререкаемый	unquestionable
новинка	novelty	g pl новинок
обедать/по-	to dine, have a meal
обрываться/оборваться	to snap; stop suddenly; stop short	p оборвусь, оборвёшься, f past оборвалась
образованный	educated
оживление	excitement, animation
относительный	relative (adj)
отныне	henceforth
отодвигать/отодвинуть (+a)	to move aside
отчаянно	desperately
официант	waiter
оформление	registration; putting in required form	оформление документов completion/registration of documents
пальма	palm tree
патриотизм	patriotism
педагогический	pedagogical, education (adj)
перебирать/перебрать (+a)	to sort out; look through; go over; sort through; to take in excess	p переберу, переберёшь, f past перебрала
переписка	correspondence
перерезать (i) (+a)	to cut	(i~p) перереза́ть/перере́зать; перережу, перережешь
печаль (f)	sorrow	(f)
плюс	plus; advantage
плясать/с-	to dance	i пляшу, пляшешь
погреб	cellar	nom pl погреба
подмигивать/подмигнуть (+d)	to wink (at)
подсчёт	calculation
подъезд	entrance, doorway
покорно	humbly, obediently
полвека	half a century	g полувека
поправка	correction	g pl поправок
попросту	simply (coll)	Он попросту устал He’s just tired
последовательность (f)	sequence; consistency	(f)
смеяться/по-	to laugh	p посмеюсь, посмеёшься
посредине (+g)	in the middle (of)	or посередине
пояснять/пояснить (+a)	to explain	i поясняю
правильность (f)	correctness	(f)
превосходство	superiority
предъявлять/предъявить (+a +d)	to show, present (sth to s.o.)	i предъявляю; p предъявлю, предъявишь
придерживаться (i) (+g)	to keep to, adhere to
прилетать/прилететь	to arrive (by air)	p прилечу, прилетишь
примесь (f)	admixture
провокация	provocation
проповедь (f)	sermon
пророк	prophet
противоречить (i) (+d)	to contradict (s.o. or sth)
процветание	flourishing; prosperity
птичий	bird’s	f птичья, n птичье
пьянство	drunkenness
радуга	rainbow
громить/раз- (+a)	to rout; wreck	p разгромлю, разгромишь
раскрываться/раскрыться	to open; be revealed, open up	p раскроюсь, раскроешься
расправа	reprisal; harsh treatment; punishment
рассматриваться (i)	to be considered
ресница	eyelash
ритм	rhythm
рыбный	fish (adj)	рыбная ловля fishing
сбиваться/сбиться	to slip; go wrong, get confused; huddle together	p собьюсь, собьёшься
своевременный	timely
сдержанный	restrained
склоняться/склониться	to bend, bow; be declined	i склоняюсь; p склонюсь, склонишься
скотина	cattle	no pl
сноха	daughter-in-law (of husband’s father)	nom pl снохи (of husband’s mother: невестка)
сообщаться/сообщиться	to be communicated; communicate with
прогноз	forecast	прогноз погоды weather forecast
спираль (f)	spiral
справка	piece of information; certificate	g pl справок; наводить справки о +pr to make enquiries (about)
спрос	demand (opposite of supply)	спрос на импортные товары demand for imported goods
сражаться/сразиться (с +inst)	to fight
топать/топнуть	to stamp (one’s feet); (coll) go (=идти)
трибуна	platform; stand (in stadium)
трястись (i)	to shake; tremble	i трясусь, трясёшься, past трясся, тряслась
тусклый	dim
тьфу	(euphemism for spitting; expressing dislike or scorn) yuk!, ugh!, pah! (coll)
убедительный	convincing; earnest
удача	success
ускорение	acceleration
успокаивать/успокоить (+a)	to calm, soothe, quieten
уступка	concession	g pl уступок
фактически	in fact; practically
церемония	ceremony
цирк	circus
четверг	Thursday	g sg четверга
чувствоваться/по-	to be felt	i чувствуется
чудесно	wonderfully
шептаться (i)	to whisper	i шепчусь, шепчешься
шумно	noisily
электроэнергия	electric power
элементарный	elementary
энергичный	energetic
энтузиазм	enthusiasm
этак	this way, thus; approximately (coll)
безупречный	irreproachable
безусловный	unconditional
берёзка	little birch tree	g pl берёзок
бесполезно	uselessly
биологический	biological
бор	pine wood, coniferous forest	pr sg в бору, nom pl боры
борщ	borsch, beetroot soup	g sg борща
борющийся	struggling
бочка	barrel	g pl бочек
выявлять/выявить (+a)	to reveal, expose	i выявляю; p выявлю, выявишь
бюджет	budget
валять (i)	to drag; to roll	валяйте! (coll) go ahead!
верность (f)	faithfulness, loyalty; truth	(f)
вертикальный	vertical
взбираться/взобраться	to climb up
вздор	nonsense  (coll)
виться/с-	to wind, twine, twist	i вьётся
вишнёвый	cherry (adj)
влага	damp, moisture
влюбляться/влюбиться (в +a)	to fall in love with	i влюбляюсь; p влюблюсь, влюбишься
возглавлять/возглавить (+a)	to head, lead	i возглавляю; p возглавлю, возглавишь
возмущённо	indignantly
волевой	strong-willed
воображать/вообразить	to imagine	i воображу, вообразишь
воронка	funnel	g pl воронок
воспринимать/воспринять (+a)	to perceive
вскидывать/вскинуть (+a на +a)	to throw (upwards, up onto)
вторник	Tuesday
вуз	university, institute (higher education establishment)
вылезать/вылезть	to climb out
выручать/выручить (+a)	to rescue; make (money)
высадка	landing, disembarkation
высылать/выслать (+a)	to send out; exile, deport	p вышлю, вышлешь
головной	head (adj)
горечь (f)	bitterness	(f)
горох	peas	no pl
грузовой	goods (adj)
двенадцатый	twelfth
девичий	girl’s, maiden’s	деви́чий or де́вичий; девичья фамилия maiden name
делить/раз- (+a)	to divide, share	i делю, делишь
деваться/деться	to get to, vanish	p денусь, денешься
досрочно	ahead of schedule
достигнутый	achieved
жар	heat	pr sg в жару
законодательный	legislative
избранный	selected
измерение	measurement; dimension
индийский	Indian
инспектор	inspector	nom pl инспектора
интервью (n indecl)	interview	n indecl
искоса	sideways (coll)
искусственно	artificially
истёкший	past, preceding
канадский	Canadian (adj)
керосин	kerosene
колокольня	bell-tower	g pl колоколен
копаться (i)	to rummage; dawdle	(i)
критик	critic
лауреат	prize-winner
любезный	obliging
любимец	favourite
мелькать/мелькнуть	to be (briefly) visible
миссия	mission
многолетний	lasting many years; long-lasting, perennial
могущественный	powerful
мода	fashion
молиться/по-	to pray	i молюсь, молишься
мудрость (f)	wisdom
наполовину	half, by half
настоящее	the present
недовольно	discontentedly
необычайно	exceptionally
нива	field, cornfield
ноготь (m)	fingernail, toenail	(m)
ноздря	nostril	nom pl ноздри, g pl ноздрей
носок	sock; toe of boot
нянька	nurse (coll)	g pl нянек
обсуждаться/обсудиться	to be discussed
огненный	fiery
ожидаться (i)	to be expected
око	eye (bookish, poetic)	nom pl очи, g pl очей
оперативный	energetic; operative
описанный	described
оплата	payment
организованный	organized
осваивать/освоить (+a)	to master
остро	sharply, intensely	-	49
отвратительный	repulsive	-	2
отделка	finishing, fitting-out, decoration	-	23
открытка	postcard	g pl открыток	23
отрывать/оторвать (+a от +g)	to tear off, tear away	p оторву, оторвёшь, past оторвал, оторвала, оторвало	28
отступление	digression; retreat	-	46
отчасти	partly	-	46
очертание	outline	-	34
пепел	ash, ashes	no pl	50
передаваться/передаться	to be transmitted	i передаётся	14
перелистывать/перелистать (+a)	to leaf through	-	26
петух	cock	g sg петуха	24
планировать/за- (+a)	to plan	i планирую	3
подавляющий	overwhelming	подавляющее большинство the great majority	12
подбегать/подбежать (к +d)	to run up (to)	p подбегу, подбежишь, подбегут	16
поднос	tray	-	27
поднятый	raised	-	27
подозрительно	suspiciously	-	29
показание	testimony; reading (on instrument)	-	31
поливать/полить (+inst +a)	to pour (liquid on sth)	-	32
помиловать (р) (+a)	to pardon	p помилую; no i; Господи, помилуй Lord, have mercy	32
по-новому	in a new way	-	32
поставка	delivery	g pl поставок	33
тушить/по- (+a)	to extinguish; stew	i тушу, тушишь	33
почерк	handwriting	-	35
почтённый	respected	-	35
пощада	mercy	-	35
предлагаться/предложиться	to be offered	-	36
предполагаться/предположиться	to be proposed, intended	i предполагается it is proposed	38
представать/предстать (перед +inst)	to appear (before)	p предстану, предстанешь; предстать перед судом to appear in court	38
прелесть (f)	charm	(f)	40
пресс-конференция	press conference	-	40
прижиматься/прижаться (к +d)	to squeeze up against; press os (to), snuggle up (to)	p прижмусь, прижмёшься	43
приманка	bait; inducement	-	44
принципиально	on principle; fundamentally	-	45
приобретение	acquisition	-	45
приоткрывать/приоткрыть (+a)	to open slightly	p приоткрою, приоткроешь	46
прихожая	entrance hall	-	46
произвол	arbitrariness, abuse of power	-	47
противоречивый	contradictory	-	47
путём (+g)	by means of	-	48
различать/различить (+a)	to distinguish	-	49
разлагать/разложить	to analyze, decompose, expand, corrupt, demoralize, break down	p разложу, разложишь	49
раскладывать/разложить	to put away, lay, set up, distribute, lay out; spread	p разложу, разложишь	50
разлука	separation	-	50
ранее	earlier
рациональный	rational
резолюция	resolution
ремонтный	repair (adj)
римский	Roman
рисковать/рискнуть (+inst)	to risk, take a risk	i рискую
росток	sprout, shoot
рулевой	steering (adj); helmsman
свинец	lead (metal)
семилетний	seven-year; seven-year-old
скользить (i)	to slide	i скольжу, скользишь
сколько-нибудь (+g)	any, any quantity of
скопление	accumulation
смертельный	fatal
снабжать/снабдить (+a +inst)	to supply (s.o. with sth)	p снабжу, снабдишь
собственник	owner
совокупность (f)	totality
созданный	created
соломенный	straw (adj)
сочувствовать (i) (+d)	to sympathize (with)	i сочувствую
специфический	specific
ставка	rate; stake (gambling); headquarters (mil)	процентная ставка interest rate
стихотворение	poem
столичный	capital (adj)
столовый	table (adj)
суета	bustle, fuss
сукин	bitch’s (poss adj)	сукин сын son of a bitch
танцевальный	dance (adj)
театральный	theatrical
типография	printing-house, press
тыкать/ткнуть (+inst в +a or +a в +a)	to prod, jab (sth into sth)	i тычу, тычешь; p ткну, ткнёшь
товарищеский	comradely; friendly
трагедия	tragedy
трепать/по-	to rumple, tousle; pat; (coll) natter	i треплю, треплешь
тропинка	path	g pl тропинок
тупой	blunt; stupid
упор	prop	в упор point-blank; сделать упор на +pr or a to emphasize
употребление	use
утрачивать/утратить (+a)	to lose	i утра́чиваю, утра́чиваешь; p утрачу, утратишь
учащийся	student (active participle)
фельетон	satirical article
хаос	chaos	ха́ос or хао́с
хищник	beast of prey; bird of prey; predator
хохот	loud laughter, guffaw
хранение	keeping; storage	срок хранения sell-by date; камера хранения left luggage office
храниться/со-	to be kept
хребет	spine; ridge; mountain range
хрупкий	fragile
целина	virgin soil, virgin land
целое	the whole; integer	(also целая) единое целое a single whole; одна целая (и) три десятых one point three (1.3)
цепочка	small chain; series	g pl цепочек
чересчур	too, excessive(ly)
чернила (n pl)	ink	g pl чернил
чёткий	clear, precise
чистить/по- (+a)	to clean	i чищу, чистишь
шестнадцать	sixteen
щи (pl)	cabbage soup	g pl щей
экономист	economist
эксплуатировать (i)	to exploit	i эксплуатирую
авось	perhaps	на авось on the off-chance
авторский	author’s
актриса	actress
алый	scarlet
ангел	angel
анкета	questionnaire, form
античный	ancient	античный мир the ancient world
арбуз	water melon
банкир	banker
бегство	flight, escape
бедность (f)	poverty
бензин	petrol
бесплатный	free (of charge)
беспокойно	restlessly; disturbing
блистательный	brilliant
болезненный	unhealthy
брызги (f) (pl)	spray	g pl брызг
вдобавок (к +d)	in addition (to) (coll)
веление	command	по велению совести according to the dictates of one’s conscience
вероятный	probable
владыка (m)	master, ruler
возбуждённый	aroused, excited
восприятие	perception
вражеский	enemy (adj)
всевозможный	all kinds of
вытеснять/вытеснить (+a)	to force out, displace
гнилой	rotten, decayed
гонять/по- (+a)	to drive, make (s.o.) run	i гоняю, гоняешь
государь (m)	sovereign	милостивый государь Dear Sir
грабить/о- (+a)	to rob, pillage	i граблю, грабишь
двигать/двинуть (+a or +inst)	to move, set in motion	i двигаю or движу, движешь
дворянин	nobleman, member of the gentry	nom pl дворяне, g pl дворян
деятельный	active
добровольный	voluntary
доносить/донести (+a до +g)	to carry (sth to); (+a +d) report (sth to s.o.); (на +a) inform (on s.o.), denounce (s.o.)	p донесу, донесёшь, past донёс, донесла
дружина	militia
дымок	puff of smoke
жевать/про- (+a)	to chew	i жую, жуёшь
житейский	worldly; everyday
загонять/загнать (+a)	to drive in	i загоняю; p загоню, загонишь, f past загнала
заголовок	title, heading
душить/за- (+a)	to strangle, suffocate, stifle	p задушу, задушишь
зажимать/зажать (+a)	to squeeze	p зажму, зажмёшь
заиграть (р) (+a)	to start playing
заказывать/заказать (+a)	to order (sth)	p закажу, закажешь
закусывать/закусить	to have a snack, have some food	p закушу, закусишь
запрещение	prohibition, ban
земляной	earthen, earth (adj)	земляной пол earth floor
знакомить/по- (+a с +inst)	to introduce (s.o. to s.o. or sth)	i знакомлю, знакомишь
известность (f)	fame	поставить кого-нибудь в известность о +pr to notify s.o. about sth
издеваться (i) (над +inst)	to mock (s.o.), make fun of
исполнительный	executive (adj); efficient
кабина	cabin
камин	fireplace
кампания	campaign
каток	skating-rink; roller
колбаса	sausage, salami	no pl
колос	ear (of corn)	nom pl колосья, g pl колосьев
командировка	business trip, study trip, assignment	g pl командировок; в командировке on a business trip etc.
костыль (m)	crutch	g sg костыля
крепнуть/о-	to get stronger, get stronger	i past креп, крепла
кружка	mug, tankard	g pl кружек
крупинка	grain	g pl крупинок
крыться/по- (в +pr)	to lie (in), be concealed (in)	i кроется; Причина кроется в ... The cause lies in ...
кубок	goblet, bowl
лишаться/лишиться (+g)	to be deprived of, lose
лужа	puddle
мальчишеский	boyish; childish
мёд	honey
мигать/мигнуть	to blink, wink
молоток	hammer
молочный	milk (adj)
мрачно	gloomily
мысленно	mentally
наваливаться/навалиться (на +a)	to fall on; lean on	p навалюсь, навалишься
надзор (за +inst)	supervision; surveillance
надлежащий	proper, fitting, appropriate
наказывать/наказать (+a)	to punish	p накажу, накажешь
накидывать/накинуть (+a)	to throw on
нападать/напасть (на +a)	to attack; come upon	p нападу, нападёшь, past напал, напала
направленный	directed; purposeful
пугать/на- (+a)	to frighten
нарастать/нарасти	to grow (on); increase
насущный	vital, essential
начисто	completely (coll)
незаметный	imperceptible
неизменный	invariable
неограниченный	unlimited
нервно	nervously
неустанно	tirelessly
обзор	survey, review
окрашивать/окрасить (+a)	to paint, colour	p окрашу, окрасишь
окрестность (f)	environs, vicinity	f; в окрестностях in the vicinity
отрицательно	negatively; unfavourably
отсталый	backward
официально	officially
пень (m)	tree-stump	g sg пня
переезжать/переехать	to drive across; move (house)	p перееду, переедешь
пересекать/пересечь (+a)	to intersect, cross, cut across	p пересеку, пересечёшь, пересекут; past пересёк, пересекла
писаться (i)	to be written; be spelt	i пишется; Как это пишется? How do you spell that?
плевать/плюнуть	to spit	i плюю, плюёшь
поговорка	saying, proverbial phrase	g pl поговорок
губить/по- (+a)	to destroy, ruin	i гублю, губишь; p погублю, погубишь
подавленный	suppressed; depressed
подносить/поднести (+a)	to take to; (+d) present to, bring	i подношу, подносишь; p поднесу, поднесёшь, past поднёс, поднесла
подъезжать/подъехать (к +d)	to drive up to	p подъеду, подъедешь
покупатель (m)	customer
полнота	fullness; stoutness
поминать/помянуть (+a)	to mention; recall	p помяну, помянешь
по-настоящему	properly, in the right way
популярность (f)	popularity
поучительный	instructive
почтительно	respectfully
превосходный	superb
предвидеть (i) (+a)	to foresee	i предвижу, предвидишь; no р
престол	throne	взойти на престол to ascend the throne
привычно	in the customary way, as usual
приготовление	preparation
приезжий	non-resident, passing through, visiting; (as noun) newcomer, visitor
приключение	adventure
проспект	avenue (wide street)
пятиться/по-	to back away, step back	i пячусь, пятишься
равнодушно	with indifference
радовать/об- (+a)	to gladden, please	i радует; p обрадую
разгар	height, climax	в разгаре +g at the height of
раздражать/раздражить (+a)	to irritate, annoy
разочарование	disappointment
раскидываться/раскинуться	to stretch out
распад	disintegration
рёв	roar
революционер	revolutionary
родственный	family (adj), kindred	родственные связи family ties
рычать/за-	to growl	i рычу, рычишь
самодеятельность (f)	individual initiative; amateur activity	вечер самодеятельности amateur concert
сбыт	sale	найти сбыт to find a market, sell well
варить/сварить (+a)	to boil, cook	p сварю, сваришь
сваривать/сварить	to weld
свинцовый	lead (adj), leaden
сговариваться/сговориться (с +inst)	to make an arrangement (with s.o.)
сдвиг	shift, displacement; change, improvement
седло	saddle	nom pl сёдла, g pl сёдел
сжимать/сжать (+a)	to squeeze	p сожму, сожмёшь
скупой	miserly
совершенство	perfection	Она владеет русским языком в совершенстве She speaks perfect Russian
созревать/созреть	to mature, ripen	p созрею, созреешь
солёный	salted
солидарность (f)	solidarity
сопровождаться (i) (+inst)	to be accompanied by
сопротивляться (i) (+d)	to resist	i сопротивляюсь
срываться/сорваться	to break away; (coll) fail, go wrong	p сорвусь, сорвёшься, f past сорвалась
ссориться/по- (с +inst)	to quarrel (with s.o.)
стихийный	elemental; spontaneous
страстно	passionately
страстный	passionate
строчка	line (of text); stitch	g pl строчек
стягивать/стянуть (+a)	to tighten; pull off	p стяну, стянешь
табуретка	stool	g pl табуреток
тайком	secretly
творение	creation
текущий	current (adj)
терпение	patience
тополь (m)	poplar	nom pl тополя
тост	toast	предложить тост за +а to propose a toast to
увозить/увезти (+a)	to take away (by transport)	i увожу, увозишь; p увезу, увезёшь, past увёз, увезла
увлекательный	fascinating, absorbing
увы	alas!
удивлять/удивить (+a)	to surprise	i удивляю; p удивлю, удивишь
устав	regulations, statutes
установленный	established, prescribed	в установленном порядке in the prescribed manner
устоять (р)	to remain standing; hold out	p устою, устоишь; no i
учебник	textbook
хлопоты (pl)	trouble, efforts	g pl хлопот, d pl хлопотам; без хлопот without difficulty
цемент	cement
чайный	tea (adj)
чинить/по- (+a)	to repair	i чиню, чинишь; p починю, починишь; чинить i/починять i
чуять/по- (+a)	to scent, smell; sense, feel	i чую, чуешь
ширина	width; gauge
эпизод	episode
яростный	furious, frenzied
авария	breakdown; accident
авторитетный	authoritative, trustworthy
адский	hellish
актив	the activists; assets (financial)
аппетит	appetite
арабский	Arab (adj), Arabian
астрономический	astronomic(al)
балка	beam, girder; gully	g pl балок
безжалостно	pitilessly, ruthlessly
беззвучно	soundlessly
безоговорочный	unconditional
белокурый	blond, fair-haired
берёзовый	birch (adj)
бесконечность (f)	infinity
бессильный	powerless
бессовестный	shameless, unscrupulous
битый	beaten; broken; whipped
бородка	small beard	g pl бородок
бывало	used to, would (repetition) (particle) (coll)	Бывало, она вставала в шесть утра She would get up at 6 a.m.
ванна	bath
вежливый	polite
верблюд	camel
вертикально	vertically
виновник	culprit
внутрь (+g)	inside; inwards
возглас	exclamation
возрождение	rebirth, revival, renaissance
восторженный	enthusiastic, rapturous
восхищение	rapture, admiration
впадина	hollow, depression
выкладывать/выложить (+a)	to lay out, put out, set out; (+a +inst) face, cover (sth with sth)	p выложу, выложишь
вырезать (+a)	to cut out	i~p; выреза́ть/вы́резать; p вырежу, вырежешь
гасить/по- (+a)	to put out, extinguish; cancel	i гашу, гасишь
гибнуть/по-	to perish	i past гиб, гибла
глобус	globe
глубинный	deep; deep-water; remote
гневный	angry
громада	mass, bulk
грубость (f)	rudeness
грызть (i) (+a)	to gnaw	i грызу, грызёшь, past грыз, грызла
диалог	dialogue
деловито	in a businesslike way, energetically
демонстрировать (i/p)	to demonstrate; (+a) show, display	(i/p) демонстрирую
дёшево	cheaply
диапазон	range, scope
дипломатия	diplomacy
доводиться/довестись (+d +inf)	to chance to, manage to, have occasion to (coll)	i доводится; p доведётся, довелось; Ей довелось побывать в Париже She had occasion to visit Paris
доживать/дожить (до +g)	to live (till)	p доживу, доживёшь
достопримечательность (f)	sight, place worth seeing
древность (f)	antiquity
желанный	wished for, welcome
женатый	married (of man)
жестокость (f)	cruelty
забавный	amusing
закреплять/закрепить (+a)	to fasten, secure	p закреплю, закрепишь
запрещённый	forbidden
запускать/запустить (+a)	to launch, throw; start up; thrust; start	p запущу, запустишь
застывать/застыть	to harden, thicken, congeal; (coll) become stiff	p застыну, застынешь
затевать/затеять (+a)	to undertake, start, organize (coll)	p затею, затеешь
затихать/затихнуть	to die down	p past зarax, затихла
захват	seizure, capture
захватчик	invader
зловещий	ominous, sinister
зрачок	pupil (of eye)
игла	needle	nom pl иглы
изобретатель (m)	inventor
калоша or галоша	galosh, overshoe
камешек	pebble
караул	guard, watch	почётный караул guard of honour
каска	helmet	g pl касок
кисть (f)	bunch (fruit); brush; tassel; hand	g pl кистей
клятва	oath
кое-кто	somebody; certain people	g кое-кого
комедия	comedy
кончик	tip, point	pl корточки; сидеть на корточках to squat
критиковать (i) (+a)	to criticize	i критикую
крутиться (i)	to turn, spin	i кручусь, крутишься
крыть/по- (+a)	to cover	i крою, кроешь
кубический	cubic
курносый	snub-nosed (coll)
лапоть (m)	bast sandal	nom pl лапти, g pl лаптей
ласка	caress; weasel	g pl ласк caress; g pl ласок weasel
лев	lion	g sg льва
ленивый	lazy
лить (i) (+a)	to pour	i лью, льёшь
лук	onions	no pl
местечко	place; small town	nom pl местечки, g pl местечек
метаться (i)	to rush about	i мечусь, мечешься
меховой	fur (adj)
микроскоп	microscope
молоденький	young and attractive; very young
монтаж	assembling, installation, mounting	g sg монтажа
мудрый	wise
музыкант	musician
набивать/набить (+a +inst)	to stuff (sth with sth)	p набью, набьёшь
наговаривать/наговорить (на +a)	(coll) to slander s.o.; (+a or +g) say a lot of	p наговорить глупостей to talk a lot of nonsense
нажимать/нажать (+a or на +a)	to press	p нажму, нажмёшь
намерен (+inf)	intend (to) (short adj)	f намерена
наслаждение	physical pleasure
наследие	legacy, heritage
наследство	inheritance
настойчивость (f)	persistence
настраивать/настроить (+a)	to tune, adjust; (на +a) put s.o. in the mood (for sth)
невероятный	improbable; incredible
негде	there is nowhere
недалёкий	near; dim, dull-witted
недобрый	hostile; evil
нейтральный	neutral
необъятный	immense, boundless
ниточка	thread	g pl ниточек
облегчение	(feeling of) relief; making lighter; simplification
обозреватель (m)	observer
обретать/обрести (+a)	to find (bookish)	p обрету, обретёшь, past обрёл, обрела
общение (с +inst)	social intercourse, contact (with people)
оканчиваться/окончиться	to end
оправдание	justification; acquittal
опушка	edge (of a forest)
особа	person; personage
отзыв	opinion, response; review, criticism
отливать/отлить (+a)	to pour off; cast (metal); (no p) (+inst) be streaked with (a colour)
отмечаться/отметиться	to register, sign one’s name
отыскивать/отыскать (+a)	to seek out, seek and find	p отыщу, отыщешь
пассажирский	passenger (adj)
первоначальный	initial, original
первостепенный	paramount
переглядываться/переглянуться (с +inst)	to exchange glances (with)	p переглянусь, переглянешься
перспективный	promising, having prospects; long-term
пирог	pie	g sg пирога
питать/на- (+a)	to feed
повидать (р) (+a)	to see (coll)
подаваться/податься	to move, shift; be served (of food)	i подаюсь, подаёшься; p подамся, подашься, подастся, подадимся, подадитесь, подадутся; подаваться
подготовительный	preparatory
позабывать/позабыть (+a оr о +pr)	to forget (coll)	p позабуду, позабудешь
коситься/по-	to become crooked; (на +a) look sideways at	p покошусь, покосишься
поликлиника	clinic, health centre
полководец	military leader
полушубок	half-length sheepskin coat
посольство	embassy
предание	legend
предпочитать/предпочесть (+a +d)	to prefer (sth to sth)	p предпочту, предпочтёшь, past предпочёл, предпочла
предрассудок	prejudice
прибытие	arrival (bookish)
призвание	calling, vocation
примитивный	primitive
принадлежность (f)	(к +d) membership (of); (pl) equipment, accessories
принц	prince
присматриваться/присмотреться (к +d)	to look closely (at); get used (to)	p присмотрюсь, присмотришься
приспособлять/приспособить (+a)	to adapt (sth)	p приспособлю, приспособишь; приспосабливать i or приспособлять i
пробегать/пробежать	to run (past/through/a certain distance)	p пробегу, пробежишь, пробегут
продаваться/продаться	to be sold; sell os	i продаюсь, продаёшься
продумывать/продумать	to think through, over
прохладный	cool
прощание	farewell, parting
пятнадцатый	fifteenth
развивающийся	developing
развязывать/развязать (+a)	to untie	p развяжу, развяжешь
раздавливать/раздавить (+a)	to crush	p раздавлю, раздавишь
размахивать (i) (+inst)	to swing (sth)
размышление	reflection, thought
ранение	wounding, wound
распадаться/распасться	to fall apart, break up
распахивать/распахнуть (+a)	to throw open
распускать/распустить (+a)	to dismiss, disband; let out	p распущу, распустишь
расставлять/расставить (+a)	to place; distribute, set out; move apart	i расставляю; p расставлю, расставишь
рекомендация	recommendation
рог	horn	nom pl рога
рыбка	small fish	g pl рыбок
рыцарь (m)	knight
салфетка	napkin; tissue; serviette	g pl салфеток
сбегать/сбежать	to run down, run away	p сбегу, сбежишь, сбегут
сдвигать/сдвинуть (+a)	to shift
серебристый	silvery
сигара	cigar
систематически	systematically
скакать/по-	to skip; gallop	i скачу, скачешь
скрипеть/про-	to squeak, creak, crunch	i скрипит; про- р/скрипнуть р
скульптура	sculpture
сложность (f)	complexity	в общей сложности all in all
снаряжение	equipment
снижать/снизить (+a)	to lower, reduce	p снижу, снизишь
совершенствовать/у- (+a)	to perfect, improve	i совершенствую
создатель (m)	creator
сознательно	consciously
сокол	falcon
сокращаться/сократиться	to decrease, be reduced, get shorter
сотый	hundredth
соус	sauce
сочувствие	sympathy
стонать (i)	to groan	i стону, стонешь
странник	wanderer
сугроб	snowdrift
сулить/по- (+a)	to promise (sth)
термин	term (specialist word)
терпеливо	patiently
террор	terror
томиться (i)	to languish, suffer	i томлюсь, томишься
тосковать (i)	to be miserable; (пo +d) yearn for, miss	i тоскую
точить (i) (+a)	to sharpen; gnaw at, corrode	i точу, точишь
тройка	three; group of three; troika	g pl троек
туфля	shoe, house shoe, slipper	g pl туфель
убеждённо	with conviction
уборная (f)	lavatory; dressing-room (in theatre)
угощать/угостить (+a +inst)	to treat (s.o. to sth), entertain	p угощу, угостишь
ударный	urgent; attacking; percussion (adj)
упадок	decline
ронять/уронить (+a)	to drop	i роняю, роняешь; p уроню, уронишь
усваивать/усвоить (+a)	to adopt, acquire (habit); master, learn
устой	foundation, support
ущелье	ravine	g pl ущелий
физиономия	physiognomy, face; shape
хвастаться/по- (+inst)	to boast (of)
хозяйничать (i)	to be in charge; throw one’s weight about
хоронить/по- (+a)	to bury	i хороню, хоронишь
царить (i)	to reign
шить/с- (+a)	to sew	i шью, шьёшь; p сошью, сошьёшь
экий	what (a) (=какой) (coll)	f эка, п экое
эстетический	aesthetic
ядовитый	poisonous; venomous
аграрный	agrarian
аптека	chemist’s, drugstore
ассоциация	association
атаковать ((i/p)) (+a)	to attack	(i/p) атакую
балет	ballet
бархат	velvet
басня	fable	g pl басен
безумный	mad
бессонный	sleepless
бесшумно	noiselessly
бодрость (f)	cheerfulness
бомбардировка	bombardment	g pl бомбардировок
боязнь (f)	fear
бриться/по-	to shave	i бреюсь, бреешься
бунт	revolt, rebellion
велосипед	bicycle
вереница	file, line, string	вереница автомобилей a line of cars
весло	oar	nom pl вёсла, g pl вёсел
взаимопонимание	mutual understanding
вихрь (m)	whirlwind
включение	inclusion
вооружать/вооружить (+a)	to arm
воскресный	Sunday (adj)
вращаться (i)	to revolve
вспомогательный	auxiliary
вторжение	invasion
выбивать/выбить (+a)	to knock out, dislodge	p выбью, выбьешь
выглядывать/выглянуть	to look out
выгодно	advantageously
вызываться/вызваться	to volunteer
выпивать/выпить	to drink (alcohol)
высовываться/высунуться	to push os forward; lean out; poke one’s head out
вытянутый	stretched
гадать (i)	to guess; tell fortunes
галерея	gallery
годовщина	anniversary
голубь (m)	pigeon, dove	g pl голубей
горсть (f)	handful	g pl горстей
гостиная (f) adj	sitting-room
груда	heap, pile
дальневосточный	Far Eastern
дежурство	(period of) duty
действенный	effective
диктовать/про- (+a)	to dictate	i диктую
диссертация	dissertation, thesis
добровольно	voluntarily
досрочный	early, ahead of schedule
живописный	picturesque
жилищный	housing (adj)	жилищные условия housing conditions
жирный	fat, fatty
жрать/со- (very coll)	to eat (very coll), gobble up	i жру, жрёшь, f past жрала
забегать/забежать	to run in; call in; run off, (coll) drop in	i забега́ть вперёд to run ahead; p забегу, забежишь, забегут; забежать вперёд to run ahead
забегать (р)	to start rushing around	р забе́гать
забываться/забыться	to be forgotten; doze off; forget os
загорелый	suntanned
зарастать/зарасти	to become overgrown; heal (of wound)	p зарастёт, past зарос, заросла
зарплата	pay, wages, salary
затягиваться/затянуться (+inst)	to be covered (by); drag on; inhale (when smoking); heal (of wound); tighten one’s belt	p затянусь, затянешься
заявка	claim, official demand	g pl заявок
земляк	person from same area	g sg земляка
избиратель (m)	voter
инженерный	engineering (adj)
ихний	their (very coll) (= их)
казна	(State) Treasury
капать/капнуть	to drip	i каплю, каплешь
карета	horse-drawn carriage
квалифицированный	qualified, skilled
кепка	cloth cap (soft, with peak)	g pl кепок
клиент	client
коварный	crafty
комбинация	combination
конёк	small horse; hobby	g sg конька
конкурент	competitor
контролировать/про- (+a)	to check	i контролирую
копыто	hoof
кофе (m) (indecl)	coffee	indecl
кошелёк	purse (for money)	g sg кошелька
критический	critical
листочек	small leaf
ловкий	dexterous, skilful, smart
ловкость (f)	dexterity, smartness
ломаться/с-	to break; (coll) put on airs; (coll) be awkward, make difficulties	с- р; по- р
малость (f)	a bit, a little	f
малыш	child (coll)	g sg малыша
массив	massif, mountain-range; large area (of sth)
материнский	maternal
мечтание	day-dreaming
миля	mile	g pl миль
минимум	minimum
мирно	peacefully
морозный	frosty
мучаться/за-	to be tormented; worry, torment os	i мучиться or мучаться; p за- or из-
мыло	soap
наблюдатель (m)	observer
навык	skill, technique
надлежать (i) (+d of person +inf)	it is necessary (= надо)	i надлежит; past надлежало
накладывать/наложить (+a на +a)	to lay sth on sth, put on, superimpose	p наложу, наложишь
насмешливый	sarcastic
натиск	onslaught; pressure
натыкаться/наткнуться (на +a)	to run into, stumble upon, meet unexpectedly	p наткнусь, наткнёшься
начинание	undertaking, initiative
неважно	not very well; it doesn’t matter
невежество	ignorance
неверный	incorrect; uncertain; unfaithful
негодование	indignation
недоразумение	misunderstanding
некрасивый	ugly
неловкость (f)	clumsiness
неспособный	incapable
нестерпимо	unbearably
неудачный	unsuccessful
низ	bottom, lower part	nom pl низы
новичок	novice, beginner
нормально	normal, OK
носиться (i)	to rush around; float, drift	i ношусь, носишься
обезьяна	monkey
овёс	oats
огорчаться/огорчиться	to be sad, distressed
одиночка (m/f)	person on his or her own, single person	m/f; g pl одиночек; мать-одиночка unmarried mother; в одиночку single-handed
ожесточённый	embittered, bitter
оживать/ожить	to revive, come to life	p оживу, оживёшь, past окреп, окрепла
оранжевый	orange (adj)
организационный	organizational
осёл	donkey	g sg осла
осмеливаться/осмелиться (+inf)	to dare
осматриваться/осмотреться	to look round, see where one is, get one’s bearings	p осмотрюсь, осмотришься
осторожность (f)	caution
остриё	point, spike	g pl остриёв
отпор	repulse, rebuff
отчество	patronymic
парламент	parliament
парус	sail	nom pl паруса
перечислять/перечислить (+a)	to enumerate; transfer (money)	i перечисляю
питаться (i) (+inst)	to feed (on)
племянник	nephew
повышаться/повыситься	to rise	p повышусь, повысишься
подавлять/подавить (+a)	to suppress	p подавлю, подавишь
подобие	resemblance, likeness
подросток	juvenile, youth
подчинённый	subordinate
подчиняться/подчиниться (+d)	to submit, be subject to	i подчиняюсь
пожениться (р)	to get married (of a couple)	p поженимся
поздравление	congratulation; greeting
ползать/по-	to crawl about
положенный	agreed, fixed
поменьше	a little less
понемногу	little by little
поразительно	strikingly, astonishingly
по-русски	in Russian; in Russian style
поставщик	supplier	g sg поставщика
похоже (на +a)	it looks like; it seems (= кажется)	Похоже на то, что ... It looks as if…
поцелуй	kiss
правительственный	government (adj)
предотвращать/предотвратить (+a)	to prevent, avert	p предотвращу, предотвратишь
предсказывать/предсказать (+a)	to predict
презирать (i) (+a)	to despise	i
претендент (на +a)	claimant, aspirant (to)
привлекательный	attractive
приговаривать/приговорить (+a к +d)	to sentence (s.o. to)
призрак	ghost
прорыв	breach
просиживать/просидеть	to sit (for a specified time)	p просижу, просидишь
прослеживать/проследить (+a)	to track, trace	p прослежу, проследишь
прощаться/проститься (с +inst)	to say goodbye (to)	p прощусь, простишься
пускаться/пуститься (в +a or +inf)	to set out, start, embark (on sth)	p пущусь, пустишься
путать/с- (+a)	to confuse, mix up
работница	female worker
развёртывать/развернуть (+a)	to unfold; expand
раздеваться/раздеться	to undress, get undressed	p разденусь, разденешься
размещать/разместить (+a)	to accommodate	p размещу, разместишь
разногласие	disagreement
расстрел	execution (by firing squad)
рваный	torn
ревность (f)	jealousy
рыбачий	fishing (adj)
рычаг	lever	g sg рычага
санаторий	sanatorium
сближение	rapprochement
сгорать/сгореть	to burn, burn out	p сгорю, сгоришь
систематический	systematic
скрипка	violin	g pl скрипок
словарь (m)	dictionary	g sg словаря
служебный	working	служебное время office hours
смирный	docile
снаружи	outside, from outside
современность (f)	the present age
согласовывать/согласовать (+a)	to coordinate	p согласую, согласуешь
соседка	(female) neighbour	g pl соседок
соскучиться (р)	to get bored; (пo +d) miss	p С ней не соскучишься You won’t get bored with her; Она соскучилась по мужу She misses her husband
спохватываться/спохватиться	to remember suddenly (coll)	p спохвачусь, спохватишься
спрашиваться (i)	to be asked	спрашивается the question is
срам	shame
стискивать/стиснуть (+a)	to squeeze	p стисну, стиснешь
сугубо	especially; exclusively
хвататься/схватиться (за +a)	to seize; (c +inst) grapple with	p схвачусь, схватишься; схватываться/хвататься i
творить/со- (+a)	to create
твориться (i)	to be going on, happen	i Что здесь творится? What’s going on here?
тезис	thesis, proposition
толковать/ис- (+a)	to interpret, explain	i толкую, толкуешь
трагический	tragic
трепетать (i)	to tremble	i трепещу, трепещешь
тропа	path	nom pl тропы
туманный	misty
турецкий	Turkish
тюремный	prison (adj)
увольнять/уволить (+a)	to dismiss, fire
увольнение	dismissal
красть/у- (+a)	to steal	p украду, украдёшь, past украл, украла
укрываться/укрыться (от +g)	to take refuge (from)	p укроюсь, укроешься
умело	skilfully
умолять/умолить (+a)	to implore	i умоляю
усиливаться/усилиться	to grow stronger, increase
ускорять/ускорить (+a)	to accelerate
устанавливаться/установиться	to become established	p установится
устремляться/устремиться	to rush, dash; be fixed on, aspire to	i устремляюсь; p устремлюсь, устремишься
утешать/утешить (+a)	to console
фонтан	fountain
формально	formally
фрукт	fruit, piece of fruit
хвалить/по- (+a)	to praise	i хвалю, хвалишь
хитрость (f)	cunning, guile (noun); ruse; (coll) ingenuity
хлынуть (р)	to gush
хомут	horse’s collar; burden, yoke	g sg хомута; надеть себе хомут на шею to impose a burden on os
хулиган	hooligan
чаёк	tea (dim), nice cup of tea	g sg чайка, partitive g чайку; Вы не хотите чайку? Would you like some tea?
чаща	thicket
что-либо	anything
шайка	tub; gang	g pl шаек
шерстяной	woollen
аналогичный	analogous
арифметика	arithmetic
арсенал	arsenal
атеист	atheist
бандит	bandit
бдительность (f)	vigilance
беззаветный	selfless
безнадёжно	hopelessly
безработный	unemployed
белеть/по-	to grow white, be white	i белеет
белизна	whiteness
бескорыстный	unconcerned with personal gain, disinterested, unselfish
беспомощный	helpless
беспощадно	mercilessly
болван	blockhead, idiot
бомбардировщик	bomber (aeroplane)
брань (f)	swearing, abuse
брести/по-	to plod along	i бреду, бредёшь, past брёл, брела
бриллиант	(cut) diamond
брошенный	abandoned
будни (pl)	weekdays	g pl будней
бывалый	experienced
вата	cotton wool
вдохновенный	inspired
ведать (i) (+inst)	to manage, be in charge of; (+a) know	i
вежливо	politely
веять (i)	to blow (wind), flutter	i веет
вешать/взвесить (+a)	to weigh	p взвешу, вывешишь; вешать i/взвешивать i
визг	scream
виновный	guilty
вникать/вникнуть (в +a)	to investigate
возлагать/возложить (+a на +a)	to lay on	p возложу, возложишь
воплощение	embodiment
восходящий	rising	восходящая звезда rising star
всенародный	national
вскрикивать/вскрикнуть	to cry out
втрое	three times (as much)	Цены повысились втрое Prices have risen threefold
вывеска	signboard	g pl вывесок
вывозить/вывезти (+a)	to transport away; export	i вывожу, вывозишь; p вывезу, вывезешь, past вывез, вывезла
выговор	reprimand; pronunciation
выносливость (f)	ability to endure, stamina
вытягиваться/вытянуться	to stretch out
вышибать/вышибить (+a)	to knock out, kick out (coll)	p вышибу, вышибешь, past вышиб, вышибла
гарнизон	garrison
глыба	large lump (of rock, ice etc.)
гордо	proudly
грамота	literacy; document, deed
грек	Greek (man)
грива	mane
грозно	threateningly
двойка	the number two; fail (mark in exam)	g pl двоек
дельный	businesslike
демократизация	democratization
детишки (pl)	children (coll)	g pl детишек
довоенный	prewar
довольствоваться (i) (+inst)	to be satisfied (with)	i довольствуюсь
достигаться/достичься	to be achieved	достигнуться p/достичься p
досуг	leisure
жестяной	tin (adj)
жутко	dreadfully
завоёванный	conquered
замирать/замереть	to stand still, die away	p замру, замрёшь, замер, замерла
орать/за-	to start yelling	i заору, заорёшь
засовывать/засунуть (+a в +a)	to thrust (sth into sth)
шуметь/за-	to make a noise	p зашумлю, зашумишь
зеленоватый	greenish
землетрясение	earthquake
злиться/обо- (на +a)	to be angry, get angry (with)	разо- p/обо- р
злость (f)	spite, bad temper
знающий	knowledgeable
золочёный	gilded
интонация	intonation
искусно	skilfully
искусный	skilful
исполинский	giant (adj)
казнить (i/p)	to execute
капуста	cabbage	no pl
карабкаться/вс-	to clamber (coll)
кататься/по-	to roll around; take a trip
квалификация	qualification
клён	maple
кол	stake (wood)	nom pl колья, g pl кольев
коллегия	board (administrative body)
колоть/за- (+a)	to chop; stab	i колю, колешь; раз- р; за- р
конверт	envelope
кооператив	cooperative
копия	copy
коробочка	small box	g pl коробочек
кремлёвский	Kremlin (adj)
критически	critically
лаять/за-	to bark	i лаю, лаешь
ливень (m)	downpour	m
лень (f)	laziness	f Ему лень идти He can’t be bothered to go
лошадиный	equine, horse (adj)
лукавый	sly
люстра	chandelier
лютый	fierce
малиновый	raspberry (adj)
манить/по- (+a)	to beckon, lure	i маню, манишь
матовый	mat(t), dull
мачта	mast
мороженое	ice-cream
мусор	litter
мыслящий	thinking
наживать/нажить (+a)	to gain, make (money)	p наживу, наживёшь, past нажила
наказание	punishment
накал	intense heat; intensity
намного	by a lot	намного лучше much better
плевать/на- (на +a)	to spit; not to give a damn about	p наплюю, наплюёшь; Ей наплевать She couldn’t care less
недоставать/недостать (+g)	to be lacking	i недостаёт
нежность (f)	tenderness	f
незадолго (до +g)	not long before
ненавистный	hated, hateful
неопределённый	indefinite, vague
нерешительно	indecisively, hesitantly
несправедливость (f)	injustice, unfairness
неудачник	failure (person)
обедня	mass (church service)	g pl обеден
обещание	promise
обнажать/обнажить (+a)	to bare, expose	p обнажу, обнажишь
обозрение	surveying, survey
обочина	roadside, kerb
обход	evasion, going round
объединяться/объединиться (с +inst)	to unite
объективно	objectively
океанский	oceanic
окошечко	little window
окружение	encirclement, surrounding
опасение	fear
опомниться (р)	to come to one’s senses	no i
оправдываться/оправдаться	to justify os; make excuses
освещённый	illuminated
отблеск	reflection
отпечаток	imprint	отпечатки пальцев fingerprints
охотиться (i) (на +a)	to hunt	i охочусь, охотишься
очнуться (р)	to regain consciousness
пазуха	bosom	за пазухой in one’s bosom
партнёр	partner
перегородка	partition	g pl перегородок
пережиток	survival, relic (of the past)
креститься/пере-	to be baptized; (p) cross os	p перекрещусь, перекрестишься
перекрещиваться	to intersect	p перекрещусь, перекрестишься
переменяться/перемениться	to change	p переменюсь, переменишься
переулок	lane
пила	saw	nom pl пилы
пирамида	pyramid
пламенный	burning
плач	weeping
плита	stove, cooker; slab	nom pl плиты
поведывать/поведать (+a)	to relate, tell
подавление	suppression
подвести (p) (к +d)	to lead up (to); (coll) let down (disappoint)	p подведу, подведёшь, past подвёл, подвела; подвести итоги to sum up
подлость (f)	mean behaviour; dirty trick
подозрение	suspicion
подружка	(female) friend (dim)	g pl подружек
поза	pose
порох	gunpowder
постановка	placing, setting; staging (of a play etc.)	g pl постановок
стареть/по-	to grow old	p постарею, постареешь
поступление	joining (an organization); arrival (of goods)
потрясение	shock
прах	dust
превосходить/превзойти (+a)	to surpass, excel	i превосхожу, превосходишь; p превзойду, превзойдёшь, past превзошёл, превзошла
преданность (f)	devotion
предварительно	beforehand, in advance
предоставление	giving, granting
предшественник	predecessor
премьер-министр	prime minister	g sg премьер-министра
преобразовывать/преобразовать (+a)	to reform; transform	p преобразую
преследование	pursuit; persecution
пресловутый	notorious
преувеличивать/преувеличить (+a)	to exaggerate
прибивать/прибить (к +d)	to nail, fix (to)	p прибью, прибьёшь
приветствие	greeting
прикрытие	cover, screen
приличный	decent
принятие	taking, acceptance
принятый	accepted
прислоняться/прислониться (к +d)	to lean (against)	p прислонюсь, прислонишься
прогулка	walk; outing	g pl прогулок
прославленный	renowned
проступать/проступить	to come through, show through
протекать/протечь	to flow; pass (of time); leak
противоположность (f)	opposite, antithesis
прошлогодний	last year’s
прощение	pardon
публичный	public	публичный дом brothel
путаться/с-	to get mixed up
пьяница (m/f)	drunkard
радиоприёмник	radio (set)
разбиваться/разбиться	to break (into pieces), get broken	p разобьётся
разбрасывать/разбросать (+a)	to scatter
раздумывать/раздумать	to change one’s mind; (i only) (o +pr) ponder
разрушаться/разрушиться	to fall apart, be destroyed
расистский	racist (adj)
расстраивать/расстроить (+a)	to upset
ребро	rib; edge	nom pl рёбра, g pl рёбер
рожа	face (very coll)
роса	dew
русло	bed (of river), channel	nom pl русла, g pl русл
самодержавие	autocracy
капиталистический	capitalist (adj)
свисток	whistle
свод	arch, vault (roof); collection of texts
семейство	family
сирена	siren
мышца	muscle	g pl мышц
сливаться/слиться	to merge, join together	p сольюсь, сольёшься, past слился, слилась
смиряться/смириться (с +inst)	to submit; resign oneself (to)
смуглый	dark (of complexion)
снижаться/снизиться	to come down, fall, go down	p снижусь, снизишься
соблюдение	observance
содействие	assistance
созывать/созвать (+a)	to convene	p созову, созовёшь, f past созвала
сознаваться/сознаться (в +pr)	to confess
соответственно	correspondingly
специализация	specialization
ставиться/пo-	to be placed
стимулирование	stimulation
стирать/вы- (+a)	to wash (clothes); rub off	вы- p; стереть p
стоящий	worthwhile (adj)
стратегический	strategic
суверенитет	sovereignty
сук	bough	g sg сука, pr sg на суку, nom pl суки, g pl суков or сучья, сучьев
суматоха	confusion, turmoil
сыпаться (i)	to pour out	i сыплется, сыплются
таиться (i)	to be concealed	i таюсь, таишься
такси	taxi	n indecl
толкаться (i)	to push, jostle	i
толща	thickness
топот	sound of footsteps, patter
трактир	inn
трибунал	tribunal
трудоёмкий	labour-intensive, laborious
угождать/угодить (+d)	to please; (coll) get into, end up (p only)	p угожу, угодишь
удобство	convenience
могила	grave
уклад	organization, structure (of life, society)
укол	jab, injection
умно	intelligently
упоминать/упомянуть (+a or о +pr)	to mention	p упомяну, упомянешь
упрямый	stubborn
усаживаться/усесться	to sit down, settle down, take a seat	p усядусь, усядешься, past уселся, уселась
устойчивость (f)	stability
ухватиться (за +a)	to grasp	p ухвачусь, ухватишься
уцелеть (р)	to survive	p уцелею, уцелеешь
фестиваль (m)	festival
финансы (m pl)	finances
хитро	cunningly
хлестать/хлестнуть (+a)	to whip	i хлещу, хлещешь
хмель (m)	hops (for beer); tipsiness	во хмелю tipsy
хоккей	(ice-)hockey
холостой	unmarried
человечек	little man
чугун	cast iron	g sg чугуна
шипеть (i)	to hiss	i шиплю, шипишь
шпион	spy
эшелон	echelon; special train
яблочко	little apple	nom pl яблочки, g pl яблочек
ясли (pl)	creche	g pl яслей
акция	share (in company)
анекдот	anecdote, joke
аристократический	aristocratic
ассамблея	assembly
багровый	crimson
барометр	barometer
барьер	barrier
безнадёжный	hopeless
безымянный	nameless	безымянный палец ring-finger
белорусский	Belorussian
береговой	coastal
беспартийный	without party affiliation, independent
бессмысленно	pointlessly, meaninglessly
бесстрашие	fearlessness
бич	whip; scourge	g sg бича
благой	good	благие намерения good intentions
бред	delirium; rubbish	pr sg в бреду
брить/по- (+a)	to shave	i брею, бреешь
брюхо	paunch (coll)
бурно	stormily; energetically
бурьян	weeds, tall weeds
бушевать (i)	to rage	i бушую, бушуешь
верховой	riding	верховая езда horse-riding
вестибюль (m)	lobby	m
весы (m pl)	scales	(m) g pl весов
ветхий	ancient, dilapidated
вечеринка	party	g pl вечеринок
взвешивать/взвесить (+a)	to weigh
влезать/влезть	to climb in	p влезу, влезешь, past влез, влезла
внедрять/внедрить (+a в +a)	to inculcate; introduce; put into practice	i внедряю
воспитательный	educational
вращение	rotation
вспоминаться/вспомниться	to be recalled, come to mind
вторично	secondarily
вторичный	second; secondary
вцепляться/вцепиться (в +a)	to grip, grip hold of	p вцеплюсь, вцепишься
вымывать/вымыть (+a)	to wash (thoroughly)	p вымою, вымоешь; мыть i, вымывать i
выходка	bad behaviour, escapade	g pl выходок
гарантия	guarantee
гараж	garage	g sg гаража
гласить (i)	to announce, say	i Документ гласит ... The document states ...
глушь (f)	backwoods, the sticks	g sg глуши
грядущий	future (bookish)
десант	landing (mil, by air or sea)
дефицитный	scarce, in short supply
директива	directive
днище	bottom (of vessel)
доезжать/доехать (до +g)	to reach	p доеду, доедешь
долой (+a)	down with
допрашивать/допросить (+a)	to interrogate
дорожить (+inst)	to value
дразнить (i) (+a)	to tease	i дразню, дразнишь
дремать (i)	to doze	i дремлю, дремлешь
дружный	amicable; simultaneous
дуэль (f)	duel
дымка	haze
дыра	hole	nom pl дыры
жильё	accommodation
забавно	amusingly
заблудиться (р)	to lose one’s way	p заблужусь, заблудишься
заваливать/завалить (+a +inst)	to block, cram	p завалю, завалишь
заинтересовываться/заинтересоваться (+inst)	to become interested in	p заинтересуюсь
запоминаться/запомниться	to stick in one’s memory
зарево	glow
затоплять/затопить (+a)	to light (stove); to flood, sink	p затоплю, затопишь; затапливать i; затоплять i
защитный	protective	защитные очки goggles
звонко	ringingly, clearly
зеркальный	mirror (adj)
знаменательный	significant
значиться (i)	to be, figure	i Она в списке не значится She’s not listed
золотистый	golden
избавлять/избавить (+a от +g)	to save (from)	p избавлю, избавишь
извержение	eruption
извне	from outside
изменник	traitor
измерять/измерить (+a)	to measure	i измеряю
изнутри	from inside
изоляция	isolation; insulation
изумление	amazement
исполняться/исполниться	to be fulfilled, be completed	i исполняется
как-никак	nevertheless, all the same (coll)
кислый	sour
клоп	bedbug	g sg клопа
клочок	tuft, scrap
кнут	whip, knout	g sg кнута
колыхаться (i)	to sway; flutter	i колышется
командный	command (adj), commanding	командные высоты the commanding heights
косвенный	oblique
котёл	boiler
крестик	little cross
кровный	blood (adj); vital
кузнец	blacksmith	g sg кузнеца
кукушка	cuckoo	g pl кукушек
легкомысленный	frivolous
лёгкость (f)	easiness; lightness
лживый	mendacious
логический	logical
манифест	manifesto; proclamation
миллионный	millionth; containing a million
мнимый	imaginary
набираться/набраться (+g)	to collect	p наберусь, наберёшься, f past набралась
нагонять/нагнать (+a)	to overtake, catch up	p нагоню, нагонишь, f past нагнала
накануне	(on) the day before	накануне Нового года on New Year’s Eve
напиток	drink
напор	pressure
нарастающий	growing
насильственный	violent, forcible
насос	pump
нашествие	invasion
невероятно	improbably
невинный	innocent
неграмотный	illiterate
недоуменно	uncomprehendingly
некоторые	some, certain (people)
немыслимо	unthinkably
неохотно	unwillingly
неразрывно	inseparably
несправедливый	unjust
неуверенно	uncertainly
нефтяник	oil worker
нехороший	bad
нечистый	unclean, impure
неясно	unclearly
оборудовать ((i/p)) (+a)	to equip	(i/p) оборудую
обряд	rite, ceremony
объявление	announcement
объятие	embrace
овладевать (i) (+inst)	to master; take possession of	i овладеть
одалживать/одолжить (+a +d)	to lend (sth to s.o.)
оживляться/оживиться	to become lively	p оживлюсь, оживишься
особняк	detached house	g sg особняка
острота	sharpness; witticism	nom pl остроты
осуждение	condemnation
отвозить/отвезти (+a)	to transport away	p отвезу, отвезёшь, past отвёз, отвезла
отвлекать/отвлечь (+a)	to distract
отвращение	disgust
отдача	return; performance, dedication (at work)	работать с полной отдачей to be a dedicated worker
отдельность	jointing; parting	каждый в отдельности each separately; в отдельности taken separately
откуда-то	from somewhere
отменять/отменить (+a)	to abolish, cancel	p отменю, отменишь
отсутствовать (i)	to be absent	i отсутствую
очищать/очистить (+a)	to clean, purify	p очищу, очистишь
парад	parade
парикмахерская	hairdresser’s, barber’s
перекидывать/перекинуть (+a через +a)	to throw over
плащ	raincoat; cloak	g sg плаща
плести (i) (+a)	to weave	i плету, плетёшь, past плёл, плела
повреждение	damage
поганый	foul, vile
погибший	lost, ruined
положено	one is supposed to	как положено as is the done thing
погружаться/погрузиться (в +a)	to immerse os (in sth)	p погружусь, погрузишься
поднятие	raising
подробный	detailed
подчёркиваться/подчеркнуться	to be emphasized
позорный	disgraceful
покачивать/покачать (+a or +inst)	to rock
покорный	humble
покрышка	covering; (coll) lid	g pl покрышек
пологий	gently sloping
получше	a little better
мириться/по- (с +inst)	to make peace, be reconciled
понижение	lowering
послевоенный	postwar
поспешно	hastily
потомок	descendant
походка	gait, walk
правитель (m)	ruler
предавать/предать (+a +d)	to betray; hand over	p предам, предашь, предаст, предадим, предадите, предадут, f past предала
предчувствие	presentiment
прелестный	charming
престиж	prestige
пригодный	useful
приготовляться/приготовиться (+inf or к +d)	to get ready	p приготовлюсь, приготовишься; приготавливаться i/ приготовляться i
прилично	decently
приписывать/приписать (+a +d)	to ascribe (sth to sth/s.o.)
приспосабливаться/приспособиться (к +d)	to adapt (to)	p приспособлюсь, приспособишься
притворяться/притвориться (+inst)	to pretend (to be sth)	i притворяюсь
притихать/притихнуть	to quieten down	p притихну, притихнешь, past притих, притихла
пробиваться/пробиться	to force one’s way through, fight one’s way through	p пробьюсь, пробьёшься
провал	failure, collapse
проводник	guide, conductor	g sg проводника
продовольствие	provisions
промышленник	industrialist
проноситься/пронестись	to rush through/past	i проношусь, проносишься; p пронесусь, пронесёшься, пронёсся, пронеслась
пропитывать/пропитать (+a)	to feed; saturate
шептать/про-	to whisper	p прошепчу, прошепчешь
прядь (f)	lock of hair	f
пряник	biscuit or cake with spices	политика кнута и пряника carrot and stick policy
пулемётный	machine-gun (adj)
путаница	confusion, mix-up
пылающий	flaming, blazing
равномерно	uniformly, evenly
развалина	ruin
раздавать/раздать (+а)	to distribute, give out	i раздаю, раздаёшь; p раздам, раздашь, раздаст, раздадим, раздадите, раздадут, f past раздала
раздвигать/раздвинуть (+a)	to move apart
раздражение	irritation
разлагаться/разложиться	to decompose, disintegrate
разумно	sensibly
рассеянно	absent-mindedly
расцвет	bloom; flourishing
расценивать/расценить (+а)	to assess
реализация	implementation; sale
резиновый	rubber (adj)
ремесло	trade (profession)	nom pl ремёсла, g pl ремёсел
реплика	rejoinder, retort
родство	kinship
рожь (f)	rye	(f) g sg ржи, inst sg рожью, pr sg во ржи
роскошь (f)	luxury	f
русый	light brown (hair)
ручаться/поручиться (за +а)	to vouch for
рывок	jerk; spurt
сваливать/свалить (+а)	to throw down; pile up	p свалю, свалишь; валить/сваливать i
светло	it’s light
сетовать/по- (о +pr/на +а)	to lament, complain (about)	i сетую, сетуешь
сжатый	compressed
скатываться/скатиться	to roll down
скверный	lousy
сколь	so
слон	elephant	g sg слона
смешивать/смешать (+а)	to confuse, mix
смущать/смутить (+a)	to embarrass; disturb; trouble	p смущу, смутишь
смущение	embarrassment
снежинка	snowflake	g pl снежинок
согревать/согреть (+a)	to warm	p согрею, согреешь
созидательный	creative
соотношение	correlation
сопка	knoll, mound; volcano	g pl сопок
сопровождение	accompaniment	в сопровождении +g accompanied by
сосновый	pine (adj)
спотыкаться/споткнуться (о +a)	to trip, stumble
спуск	descent; slope; release
старина	bygone times; (coll) old fellow
старомодный	old-fashioned
стаскивать/стащить (+a)	to drag off; (coll) pinch	p стащу, стащишь
стойкий	stable; steadfast
столбик	small column
сторожевой	watch, guard (adj)
стоянка	stop; parking	g pl стоянок; стоянка такси taxi rank
трусить/с- (перед or +g)	to be cowardly	p струшу, струсишь
ездить/съ-	to travel there and back	p съезжу, съездишь
таблетка	pill	g pl таблеток
тайно	secretly
таможенный	customs (adj)
твердить (i) (+a)	to repeat	i твержу, твердишь
теплица	hothouse
травить (i) (+a)	to exterminate, poison; damage; hunt; persecute	i травлю, травишь
транспортный	transport (adj)
тропический	tropical
трофей	trophy; booty
тур	round (sport)
туристский	tourist (adj)
тяга	locomotion; (к +d) thirst for, attraction towards
удалять/удалить (+a)	to send away, remove
удивлённый	surprised
указ	decree
умываться/умыться	to wash os	p умоюсь, умоешься
унижение	humiliation
упомянутый	previously mentioned
ураган	hurricane
формальный	formal
характерно	characteristically
хмурый	gloomy
храбрый	brave
цементный	cement (adj)
чаша	cup; chalice
черпать/черпнуть (+a из +g)	to scoop, draw (from)
честность (f)	honesty	f
четвёрка	four; group of four
чугунный	cast-iron (adj)
шанс	chance
шапочка	small hat	g pl шапочек
шёлк	silk
шибко	very (coll)
шут	jester, clown	g sg шута
щедро	generously
щёлкать/щёлкнуть (+а)	to flick; (+inst) click, crack, snap
эгоизм	egoism, selfishness
энергично	energetically
энтузиаст	enthusiast
юмор	humour
юношеский	youthful
январский	January (adj)
амнистия	amnesty
асфальт	asphalt
аэропорт	airport	pr sg в аэропорту
баловать/из- (+a)	to spoil (s.o.)	i coll баловатьбалую
баррикада	barricade
барский	lord’s, barin's
безлюдный	lacking people, unfrequented
безразлично	indifferently
бесповоротно	irreversibly
беспредельный	boundless, unlimited
бесцеремонно	unceremoniously
благородство	nobility
блаженный	blessed
болтовня	chatter, gossip (coll)
бомбёжка	bombardment (coll)
брезгливо	squeamishly
бронза	bronze
бутылочка	small bottle	g pl бутылочек
валун	boulder	валуна
варежка	mitten	g pl варежек
веселиться/по-	to make merry
ветчина	ham
взаимно	mutually
виновато	guiltily
внешне	outwardly
внешность (f)	exterior
возражение	objection
волжский	Volga (adj)
воровать/с- (+a)	to steal	i ворую
ворочать (+a)	to move (sth heavy); (+inst) have control of
ворочаться (i)	to turn, toss and turn (coll)
впадать/впасть (в +a)	to fall in/into	p впаду, впадёшь, past впал, впала
враз	all together (coll)
вручную	by hand
вставлять/вставить (в +a)	to insert	i вставляю; p вставлю, вставишь
вступление	introduction
втроём	as a threesome
выносливый	resilient
высаживаться/высадиться	to disembark, land	p высажусь, высадишься
высказываться/высказаться	to speak out, state one’s opinion	p выскажусь, выскажешься
вычислять/вычислить (+a)	to calculate
гармонический	harmonious
гладко	smoothly
голубоватый	light-bluish
гуманный	humane
давным-давно	ages ago (coll)
дворянский	gentry (adj)
дёргать/дёрнуть (+a)	to tug
детектив	detective story
дико	wildly; absurd
добавка	addition	g pl добавок
докатываться/докатиться (до +g)	to roll to, come to	p докачусь, докатишься
домишко (m)	shack, hovel	(m) nom pl домишки, g pl домишек
дополнительно	additionally
доставка	delivery
достойно	worthily, properly
дурацкий	idiotic, stupid (coll)
душно	stuffy
дымить (i)	to smoke	i дымлю, дымишь
жаждать (i) (+g)	to thirst for	i жажду, жаждешь
забава	amusement
завеса	screen
заданный	set, assigned
зажиточный	well-off
закрываться/закрыться	to be closed; close down; cover os	p закроюсь, закроешься
закупка	purchase
занимательный	entertaining, interesting
запугивать/запугать (+a)	to intimidate
запутанный	confused, tangled
заседать (i)	to sit, be in session
застревать/застрять	to get stuck	p застряну, застрянешь
заход	sunset; call (at a place)
зачастую	often (coll)
звуковой	sound (adj)
змея	snake	nom pl змеи, g pl змей, d pl змеям
иго	yoke (oppression)
игрушечный	toy (adj); tiny
идеальный	ideal (adj)
изобразительный	graphic; decorative
иронически	ironically
искренно	sincerely
истребитель (m)	fighter (plane)
исходный	initial
каблук	heel	g sg каблука
канава	ditch
кандидатура	candidature
капризный	capricious
кара	punishment
караулить (i) (+a)	to guard; lie in wait for
категорически	categorically
клок	rag, shred, tuft	g sg клока, nom pl клочья, g pl клочьев or клоки, клоков
конкретно	concretely, specifically
косынка	headscarf	g pl косынок
кофта	blouse
крайность (f)	extreme	f
красавец	handsome man
крошечный	tiny
крылатый	winged
кувшин	jug, pitcher
куриный	hen’s	куриная память memory like a sieve
лазить/по-	to climb	i лажу, лазишь
ленточка	small ribbon	g pl ленточек
лиловый	violet, lilac
лихо	dashingly, with spirit (coll)
лихорадка	fever; rash
ломка	breaking
лохматый	shaggy
лыжник	skier
лыжный	ski (adj)
майский	May (adj)
мамочка	mummy
математик	mathematician
меньшинство	minority
метла	broom	nom pl мётлы, g pl мётел
миллионер	millionaire
милостыня	alms	no pl
миниатюрный	miniature (adj)
модный	fashionable
монастырь (m)	monastery; convent	g sg монастыря
мускул	muscle
мучительно	excruciatingly
назло	out of spite; (+d) to spite (s.o.)
наименование	designation, name
напряжённо	with strain, intensively
нарушаться/нарушиться	to be broken, be infringed
наследник	heir
насчитывать (i) (+а)	to number, total
невыносимый	intolerable
неизмеримо	immeasurably
ненадолго	not for long
неохота	reluctance; (coll) (+d) to be unwilling	Ему неохота He doesn’t feel like it
неприятель (m)	enemy
неторопливо	unhurriedly
неторопливый	unhurried
неуловимый	elusive
нехватка	shortage (coll)	g pl нехваток
нечаянно	accidentally; unexpectedly
новенький	brand-new, nice and new
носилки (f pl)	stretcher	f pl; g pl носилок
носовой	nose (adj), nasal
обилие	abundance
обобщать/обобщить (+а)	to generalize
обгонять/обогнать (+a)	to overtake, outstrip	p обгоню, обгонишь, f past обогнала
обожать (i) (+а)	to adore
обрез	cut edge	+g в обрез none to spare; Времени в обрез Time is very short
обхватывать/обхватить (+а)	to encompass	p обхвачу, -атишь
ограничение	limitation
ограниченность (f)	narrowness	f
однородный	homogeneous, of one type
одолевать/одолеть (+а)	to overcome	p одолею, одолеешь
ожерелье	necklace	g pl ожерелий
озарять/озарить (+a)	to illuminate
озорство	naughtiness (coll)
оккупация	occupation
округ	okrug, region	nom pl округа
окурок	cigarette end
опровергать/опровергнуть (+a)	to refute, disprove
пустеть/о-	to empty, become empty	p опустеет
орёл	eagle	g sg орла
основательно	solidly, soundly, thoroughly
откидываться/откинуться	to lean back
отмахиваться/отмахнуться (от +g)	to brush off
отмена	abolition, cancellation
отметка	note, mark	g pl отметок
отрабатывать/отработать (+a)	to work off (debt etc.), work (shift etc.), finish working
отставка	retirement, resignation
отход	departure
отчётливый	clear, distinct
парашют	parachute
парнишка (m)	lad (coll)	g pl парнишек
педагог	pedagogue, teacher
переворачивать/перевернуть (+a)	to turn over
передвижение	movement
передразнивать/передразнить (+a)	to mimic
перемещаться/переместиться	to move
перемещение	displacement, shifting
перепутывать/перепутать (+a)	to tangle, confuse
пересматривать/пересмотреть (+a)	to reconsider	p пересмотрю, пересмотришь
персонаж	character
персональный	personal
побеждённый	defeated
поблёскивать (i)	to gleam	i
повестка	notification	повестка дня agenda
повторный	repeated
повязка	bandage	g pl повязок
погоня	pursuit
подвигаться/подвинуться	to move; advance
поджигать/поджечь (+a)	to set fire to	p подожгу, подожжёшь, подожгут, past поджог, подожгла
подол	hem
подрывать/подорвать (+a)	to undermine	p подорву, подорвёшь, f past подорвала
подтверждение	confirmation
подтягивать/подтянуть (+a)	to tighten; pull up	p подтяну, подтянешь
позавчера	the day before yesterday
пола	flap (of coat etc.)	nom pl полы
полено	log	nom pl поленья, g pl поленьев
ломать/по- (+а)	to break
полотно	canvas (painting); linen	nom pl полотна, g pl полотен, d pl полотнам
полуостров	peninsula	nom pl полуострова
порабощение	enslavement
посвистывать/посвистеть	to whistle
поселяться/поселиться	to take up residence
пособие	financial assistance; textbook, educational aid	пособие по безработице unemployment benefit
постепенный	gradual
потрясать/потрясти (+a)	to shake
потрясающий	staggering, astonishing
похвала	praise
почтовый	postal, mail (adj)
править (i) (+inst)	to rule	i правлю, правишь
праздновать (i) (+a)	to celebrate	i праздную
предназначаться/предназначиться (для +g or на +a)	to be intended for
прекращать (i) (+a)	to stop, discontinue
прибегать/прибежать	to run up, come running	p прибегу, прибежишь, прибегут
приближение	approach
прибирать/прибрать (+a)	to tidy up; (coll) take over, pocket	p приберу, приберёшь, f past прибрала
привязываться/привязаться (к +d)	to become attached to	p привяжусь, привяжешься
прилавок	counter (in shop)
примечательный	noteworthy
примиряться/примириться (с +inst)	to be reconciled with
припоминать/припомнить (+a)	to remember, recall
приставлять/приставить (+a к +d)	to place sth against sth	p приставлю, приставишь
приставать/пристать (к +d)	to stick to, adhere (to); pester	i пристаю, пристаёшь; p пристану, пристанешь
провозглашать/провозгласить (+a)	to proclaim	p провозглашу, провозгласишь
проглатывать/проглотить (+a)	to swallow	p проглочу, проглотишь
продавец	salesman, shop assistant	g sg продавца
продолжить (p) (+a)	to prolong	p
проливать/пролить (+a)	to spill	p пролью, прольёшь, f past пролила
молчать/про-	to keep silent	p промолчу, промолчишь
проскакивать/проскочить	to rush past; slip through	p проскочу, проскочишь
прославляться/прославиться	to become famous	p прославлюсь, прославишься
просматривать/просмотреть (+a)	to look over; overlook, look through	p просмотрю, просмотришь
просчёт	miscalculation; counting
противостоять (i) (+d)	to resist	i противостою, противостоишь
проход	passage; passageway
равномерный	even, uniform
равноправие	equality
разваливаться/развалиться	to fall to pieces	p развалится
развёртывание	unfolding; development
развлечение	entertainment
раздражаться/раздражиться	to become irritated
раскол	split, schism
расписка	receipt	g pl расписок
расплачиваться/расплатиться	to settle up, pay
распорядок	routine
распределяться/распределиться	to be distributed	i распределяется
рассеиваться/рассеяться	to disperse; give os a break
расстёгивать/расстегнуть (+a)	to unfasten
растить/вы- (+a)	to grow, raise	i ращу, растишь
рвануться (р)	to dash	p рванусь, рванёшься
редакционный	editorial, editing
репортаж	reporting
реставрация	restoration
родимый	native; dear (= родной)	= родной
румянец	flush, rosy complexion
рыть (i) (+a)	to dig	i рою, роешь
свежесть (f)	freshness
свержение	overthrow
своевременно	in good time
сдержанно	with restraint
сестрёнка	little sister	g pl сестрёнок
сигарета	cigarette
скачок	leap
скверно	badly
склонность (f) (к +d)	tendency (to); aptitude (for)	f
скрип	squeak, creak
словесный	verbal
словечко	word (coll)	g pl словечек
сложившийся	developed
смутный	vague, dim; troubled
сгибаться/согнуться	to bend; stoop
сокровищница	treasure-house
сонный	sleepy
сороковой	fortieth
сосать (i) (+a)	to suck	i сосу, сосёшь
сочетаться (i) (с +inst)	to combine (with)
спальня	bedroom	g pl спален
спасаться/спастись	to escape, save os	p спасусь, спасёшься, past спасся, спаслась
списывать/списать (+a)	to copy; write off	p спишу, спишешь
спичечный	match (adj)	спичечная коробка matchbox
спящий	sleeping
среднеазиатский	Central Asian
средневековый	medieval
статься	to happen (coll)	p станется
стихать/стихнуть	to abate, die down	p past стих, стихла
строгость (f)	strictness
сумрак	dusk
суп	soup
сушёный	dried
сформулировать (р) (+a)	to formulate	p сформулирую; формулировать (i/p)
съёмка	shooting (of film); surveying; taking away	g pl съёмок
съезжать/съехать	to drive down; (coll) slip	p съеду, съедешь
сюрприз	surprise
таинственно	mysteriously
такт	rhythm, time; tact	в такт музыке in time to the music; отсутствие такта tactlessness
телескоп	telescope
толпиться (i)	to crowd, throng
тормозить/за- (+a)	to slow down, impede; brake	i торможу, тормозишь
трезвый	sober
трон	throne
трос	rope, cable
тщеславие	vanity
убогий	wretched
углубление	deepening; depression, hollow
углубляться/углубиться	to become deeper; (в +a) go deep into, become absorbed in	i углубляюсь
удачно	successfully
улетать/улететь	to fly away	p улечу, улетишь
уменьшать/уменьшить (+a)	to reduce
уста (pl)	mouth; lips (poetic)	g pl уст, d pl устам; из уст в уста by word of mouth
условный	conventional; conditional; tentative
усталость (f)	tiredness	f
уткнуться (р) (в +a)	to bury os in; bump into
фигурка	small figure; figurine	g pl фигурок
форточка	ventilation window	g pl форточек
фыркать/фыркнуть	to snort
хлам	junk
хорошенький	pretty
худощавый	thin
цвести/рас-	to flower, flourish	i цвету, цветёшь, past цвёл, цвела
цветочный	flower (adj)
цельный	entire
цыплёнок	chicken	nom pl цыплята, g pl цыплят
цыпочки (pl)	tiptoes	на цыпочках on tiptoe
чек	cheque; receipt
череп	skull	nom pl черепа
чудиться/по- (+d)	to seem, imagine (coll)	i чудится; по- p/при- р; p Мне почудилось, что я слышу шаги I thought I heard footsteps
чулок	stocking	g pl чулок
чуть-чуть	a little bit, just a little (coll)
шарить/по- (в +pr)	to grope, fumble
шелест	rustling
штамп	stamp, punch; cliche
штраф	fine
штурм	storm, assault
штучка	thing, object (coll)	g pl штучек
щедрый	generous
экономически	economically
эстрадный	stage (adj)
эхо	echo
яд	poison
яростно	furiously
автоматика	automation; machinery
адресовать ((i/p)) (+a +d)	to address (sth to s.o.)	(i/p) адресую
арка	arch	g pl арок
археолог	archaeologist
афоризм	aphorism
балл	mark (exam)
бедняга (m)	poor fellow (coll)	m
безграничный	limitless
безделье	idleness
безжалостный	pitiless
безопасный	safe
барак	hut
белка	squirrel	g pl белок
блин	pancake	g sg блина
бессмысленный	senseless, meaningless
библия	bible; the Bible
биология	biology
благословлять/благословить (+a)	to bless	i благословляю; p благословлю, благословишь
блеснуть (р)	to flash
блестяще	brilliantly
бодрый	cheerful, in good form
бойкий	smart, lively
будничный	weekday (adj); dull, everyday
булка	small loaf	g pl булок
вдохновение	inspiration
вдумываться/вдуматься (в +a)	to ponder on
ведомость (f)	list, register
веер	fan	nom pl веера
вертолёт	helicopter
верующий	believer (religious)
верховье	upper reaches (of river)	g pl верховьев
вещественный	substantial, material
взаимопомощь (f)	mutual assistance
взлетать/взлететь	to fly up	p взлечу, взлетишь
визжать (i)	to scream; squeal	i визжу, визжишь
виноград	grapes
водоём	reservoir
возводить/возвести (+a)	to raise	i возвожу, возводишь
возвращать/возвратить (+a)	to return	p возвращу, возвратишь
возвышаться/возвыситься	to rise
возмездие	retribution
вой	howl; wailing
волосатый	hairy
восторженно	enthusiastically
восход	rise
впрямь	indeed (coll)
всемерно	in all possible ways
всесторонне	thoroughly
вскрывать/вскрыть (+a)	to unseal; disclose; dissect; open; reveal	p вскрою, вскроешь
всплеск	splash
второстепенный	secondary, subsidiary
в-четвёртых	fourthly
выключать/выключить (+a)	to switch off
выписывать/выписать (+a)	to write out; subscribe to (periodical)	p выпишу, выпишешь
выпрямляться/выпрямиться	to become straight, straighten up	p выпрямилюсь, выпрямишься
выпускаться/выпуститься	to be released
выразительный	expressive
высказывание	utterance, statement
стрелять/выстрелить (в +a)	to shoot, fire (at)
выхватывать/выхватить (+a)	to snatch, pull out	p выхвачу, выхватишь
вьюга	snowstorm
гениальный	brilliant
гидростанция	hydroelectric station
глубь (f)	depth
горевать (i)	to grieve	i горюю, горюешь
горизонтальный	horizontal
горожанин	town-dweller	nom pl горожане, g pl горожан
гостеприимство	hospitality
грипп	influenza
грузинский	Georgian
двоюродный	related through grandparent	двоюродный брат cousin; двоюродная бабушка great-aunt; двоюродный дед great-uncle, grand-uncle
декларация	declaration
дерзкий	cheeky; daring
детально	minutely, in detail
доблесть (f)	valour	f
добродушный	good-natured
добротный	high-quality
дурно	bad(ly)
душить (i) (+a)	to strangle; perfume	i душу, душишь
ежедневный	daily, everyday
жадность (f)	greed	f
жатва	reaping, harvest
жизненность (f)	vitality; lifelikeness
жук	beetle	g sg жука
журналистика	journalism
заботливый	solicitous, caring
заваривать/заварить (+a)	to brew	p заварю, заваришь
заводиться/завестись	to start (working); (coll) get worked up	p заведусь, заведёшься, past завёлся, завелась; Мотор завёлся The engine started
зависимый	dependent
глушить/за- (+a)	to drown (a sound)	глушить i/заглушать i
заграничный	foreign
гудеть/за-	to start hooting/humming	p загужу, загудишь
задирать/задрать (+a)	to tear to pieces; lift up (coll)	p задеру, задерёшь
заимствовать/по- (+a)	to borrow	i заимствую
заинтересованность (f) (в +pr)	interest (in)	f
закидывать/закинуть (+a)	to cast, toss
законность (f)	legality	f
закономерный	regular, predictable
закуска	hors-d’oeuvre; snack	g pl закусок
замерзать/замёрзнуть	to freeze	p past замёрз, замёрзла
запасный	spare, reserve	(= запасной)
запоздалый	belated
заряжать/зарядить (+a)	to load (weapon); charge (electrical equipment)	p заряжу, зарядишь
застреливать/застрелить (+a)	to shoot dead	p застрелю, застрелишь
застывший	congealed; frozen
затея	venture, undertaking; game, escapade; embellishment
затыкать/заткнуть (+a)	to stop up, plug	p заткну, заткнёшь
звёздный	star (adj); starry
звучание	sound, sounds
земельный	land (adj)
зрелость (f)	maturity	f
измена	betrayal
инвалид	invalid
иней	hoar-frost
инстанция	instance, stage (in legal proceedings); department
исполнитель (m)	executor; performer	m
испуг	fright
истреблять/истребить (+a)	to destroy, exterminate	i истребляю; p истреблю, истребишь
канун	eve	в канун +g on the eve of sth
кашлять/кашлянуть	to cough	i кашляю
квадрат	square
колея	rut
колпак	cap	g sg колпака; ночной колпак nightcap
коляска	pram; carriage	g pl колясок
ком	lump, ball	nom pl комья, g pl комьев
конкуренция	competition
контролёр	inspector
корыто	tub; trough
косить/с-	to mow; twist	i кошу, косишь
кошмар	nightmare
кратко	briefly
кулисы	wings (theatre)	g pl кyлиc; за кулисами behind the scenes
кусать (i) (+a)	to bite; sting
лабиринт	labyrinth
легендарный	legendary
лечебный	medical, medicinal
литр	litre
лысина	bald patch
массивный	massive
матрос	sailor
машинка	(small) machine	g pl машинок; пишущая машинка typewriter
медикамент	medicine	медикаменты medical supplies, drugs
мель (f)	shoal, (sand)bank	f; pr sg на мели high and dry
меч	sword	g sg меча
мещанин	petty bourgeois, lower middle class person; philistine	nom pl мещане, g pl мещан
милостивый	gracious, kind	милостивый государь Dear Sir
многообразие	diversity
морально	morally
моргать/моргнуть	to blink; wink
москвич	Muscovite	g sg москвича
мохнатый	shaggy
мрак	darkness, gloom
мстить/ото- (+d за +a)	to take revenge (on s.o. for sth)	i мщу, мстишь
мучительный	excruciating
мыслитель (m)	thinker	m
набок	awry, on one side
нависать/нависнуть	to overhang
навязывать/навязать (+a +d)	to impose, foist (sth on s.o.)	i past навис, нависла; p навяжу, навяжешь
награждать/наградить (+a)	to reward	p награжу, наградишь
нажим	pressure; clamp
наивно	naively
наилучший	the best
накопляться/накопиться	to accumulate	накопится; накапливаться i/накопляться i
налицо	present, visible	Все необходимые условия налицо All the essential conditions are present
намекать/намекнуть (на +a)	to allude to
намереваться (i) (+inf)	to intend
насекомое	insect
наслаждаться/насладиться (+inst)	to delight (in), get physical pleasure (from)
наспех	hastily
насчитываться (i)	to number, total	i
негр	negro
негритянский	negro (adj)
недовольство (+inst)	dissatisfaction (with)
незачем (+i inf)	there’s no point
неинтересно	(it’s) uninteresting
нейтралитет	neutrality
немой	dumb, silent, mute
неотложный	urgent
нерешительность (f)	indecisiveness	f; pr sg на мели high and dry
неслыханный	unprecedented
несметный	countless
неужто	really? (coll)	= неужели
новорождённый	new-born
обжигать/обжечь (+a)	to burn; bake, fire (bricks etc.)	p обожгу, обожжёшь, обожгут, past обжёг, обожгла
обиженно	resentfully, looking hurt
обмениваться/обменяться (+inst)	to exchange	p обменяемся;обменяться взглядами to exchange glances
оборонный	defence (adj)	оборонная промышленность defence industry
оговорка	reservation, proviso; slip of the tongue	g pl оговорок; согласиться с оговорками to agree with reservations
одеваться/одеться	to dress
однообразный	monotonous
односторонний	one-sided; one-way
оживлённо	animatedly, excitedly
озорной	mischievous (coll)
озябнуть (р)	to get cold, chilled	p past озяб, озябла
окаянный	cursed
окликать/окликнуть (+a)	to hail, call (to s.o.)
оскорблять/оскорбить (+a)	to insult	i оскорбляю; p оскорблю, оскорбишь
осмотр	inspection
остывать/остыть	to cool down, get cold	p остыну, остынешь
отвлечённый	abstract
отворять/отворить (+a)	to open	p отворю, отворишь
откидывать/откинуть (+a)	to throw away, throw back
откровенность (f)	frankness	f
отлив	ebb, falling tide; tinge, tint, play of colours
отрыв (от +g)	tearing off; isolation (from)
отталкивать/оттолкнуть (+a)	to push away, repel
оформлять/оформить (+a)	to put into proper form	i оформляю; p оформлю, оформишь
палить/с- (+a)	to burn, scorch; singe	(p c-) to burn, scorch; (p o-) singe
паровой	steam (adj)
пасти (i) (+a)	to graze; to shepherd	i пасу, пасёшь, past пас, пасла
пенсионер	pensioner
паёк	ration	g sg пайка
перевозить/перевезти (+a)	to transport across, from swh to swh	p перевезу, перевезёшь, past перевёз, перевезла
перевязывать/перевязать (+a)	to bandage; tie up	p перевяжу, перевяжешь
перехватывать/перехватать (+a)	to intercept	p перехвачу, перехватишь
перечитывать/перечитать (+a)	to reread
печататься (i)	to be printed, be published	i
пищевой	food (adj)	пищевая промышленность food industry
бледнеть/по-	to turn pale	i бледнею, бледнеешь; p побледнею, побледнеешь
бояться/по-	to be afraid, not dare to	p побоюсь, побоишься
поверхностный	superficial
повисать/повиснуть	to hang, dangle; droop, sag	p повисну, повиснешь, past повис, повисла
погром	pogrom, massacre
поддаваться/поддаться (+d)	to yield, give way (to)	i поддаюсь, поддаёшься
подлинно	genuinely
подкладывать/подложить (+a)	to put under; add	p подложу, подложишь
подрывной	undermining; subversive
покрываться/покрыться (+inst)	to be covered (with), cover os (with)	p покроюсь, покроешься
кушать/по-	to eat (polite usage)
полушарие	hemisphere
полюс	pole (geog)	Северный полюс North Pole
помниться (i) (+d)	to be remembered	(Мне) помнится I remember
поодаль	at some distance
поправляться/поправиться	to get better; correct os; put on weight	p поправлюсь, поправишься
поравняться (р) (с +inst)	to draw level with, come up to	p поравняюсь
порция	portion
постановлять/постановить	to decide, resolve	p постановлю, постановишь
по-старому	as before
потихоньку	slowly; quietly; secretly (coll)
потрудиться (p) (+inf)	to take the trouble (to); do some work	p потружусь, потрудишься; Потрудитесь закрыть дверь Could I ask you to close the door?
хлопать/по-	to slap, clap
почёт	esteem, respect
празднование	celebration
преданный	devoted
предвидение	foresight
предельно	maximally
предельный	maximum (adj)
предпосылка	prerequisite, precondition	g pl предпосылок
президентский	president’s, presidential
пренебрежение	scorn, neglect
преподавать (i) (+a)	to teach	i преподаю, преподаёшь
претендовать (i) (на +a)	to claim (sth)	i претендую
привлечение	attraction
прилив	rising tide; influx
приподниматься/приподняться	to raise os slightly	p приподнимусь, приподнимешься, past приподнялся, приподнялась
присвоение	appropriation; conferment	незаконное присвоение misappropriation
пристрастие (к +d)	partiality; weakness (for)
приток	tributary; inflow
пришивать/пришить (+a к +d)	to sew on	p пришью, пришьёшь
проба	test, trial	метод проб и ошибок trial and error
продвижение	advancement, progress
проклинать/проклясть (+a)	to curse
пронизывать/пронизать (+a)	to pierce, penetrate, permeate
проникновение	penetration
пружина	spring (mechanism)
пульт	control panel; music-stand
пшеничный	wheat (adj), wheaten
пытка	torture	g pl пыток; Попытка не пытка It won’t hurt to try
равнодушие	indifference
разгораться/разгореться	to flare up, blaze up	p разгорится
разоблачение	exposing, unmasking
раскрытый	wide-open
расовый	racial
расположенный	situated; (к +d) inclined, disposed to
распределять/распределить (+a)	to distribute; allocate
расслышать (р)	to catch (sth said)	p Простите, я не расслышала Sorry, I didn’t catch that
рассуждать/рассудить (+a)	to arbitrate (between), judge; decide	p рассужу, рассудишь
растерянность (f)	bewilderment, dismay	f
расходовать/из- (+a)	to spend, use up	i расходую
рецепт	recipe; prescription
румяный	rosy, ruddy
рушиться/об-	to collapse
рыхлый	friable, crumbly; (coll) podgy, flabby
свечка	small candle	g pl свечек
свирепый	ferocious
своеобразие	peculiarity, individuality
связываться/связаться (с +inst)	to get in touch with; communicate with; (coll) get involved with	p свяжусь, свяжешься
святыня	sacred place or thing
сжиматься/сжаться	to tighten, clench
символ	symbol
символический	symbolic
сирота (m/f)	orphan	m/f; nom pl сироты
скорбный	(grammatical term) mournful
скудный	meagre
скуластый	with high cheek-bones
следователь (m)	investigator	m/f; nom pl сироты
следом (за +inst)	behind
служение (+d)	service (to), serving
смотр	inspection, review
сознательность (f)	awareness
созыв	calling, summoning (of meeting)
сопеть (i)	to snuffle	i соплю, сопишь
соревноваться (с +inst)	to compete, vie (with)	i соревнуюсь
сплочённость (f)	unity, solidarity
срабатывать/сработать	to work (function) properly	p Механизм сработал The mechanism worked
суждение	opinion, judgement
супруг	spouse (husband)
существенно	vitally, essentially
сыпать/по- (+a or +inst)	to pour, strew	i сыплю, сыплешь
табачный	tobacco (adj)
творец	creator
тереть/по- (+a)	to rub	i тру, трёшь, past тёр, тёрла
толкование	interpretation
тонкость (f)	thinness; subtlety	f
торопить/по- (+a)	to hurry (s.o.)	i тороплю, торопишь
тракт	highway; route
трещать (i)	to crack; crackle	i трещит
тридцатый	thirtieth
трость (f)	cane, walking-stick	f; g pl тростей
туннель (m)	tunnel	m
угрожающий	threatening
укладываться/уложиться	to pack one’s things; (в +a) fit (into sth)
укладываться/улечься	to lie down, go to bed; (p only) calm down; (p only) settle	p улягусь, уляжешься, улягутся, past улёгся, улеглась
уклон	slope; deviation, bias
украдкой	stealthily
улавливать/уловить (+a)	to catch; detect	p уловлю, уловишь
упускать/упустить (+a)	to let slip; miss	p упущу, упустишь
усик	whisker; antenna, feeler	усики small moustache
ускользать/ускользнуть	to slip away
устье	mouth, estuary	g pl устьев
уточнять/уточнить (+a)	to make more precise; verify
утрата	loss
ухаживать (i) (за +inst)	to look after (s.o.); make advances (to a woman)
участь (f)	fate, lot (in life)	f
уютный	cosy
фабричный	factory (adj)
фаза	phase
федерация	federation
хвойный	coniferous
хмуро	gloomily, sullenly
худенький	slim, thin (coll)
централизованный	centralized
цитата	quotation
частичный	partial
чередоваться (i) (c +inst)	to alternate (with)	i чередуюсь
чертить/на- (+a)	to draw, draw up	i черчу, чертишь
числиться (i)	to be, be listed; (+inst) be considered (to be sth)	i Она не числится в этом списке She’s not on this list
чувствительный	sensitive
чулан	store-room, box-room
чума	plague
чуточку	a little (coll)
шведский	Swedish
шестьсот	six hundred	g шестисот
шкатулка	casket, box	g pl шкатулок
шлёпать/шлёпнуть (+a)	to smack
шорох	rustle
щётка	brush	g pl щёток
экономить/с- (+a)	to save, economize	i экономлю, экономишь
этикетка	label	g pl этикеток
юрист	lawyer
явственно	clearly
ягода	berry
аналогия	analogy
аромат	scent, aroma
балтийский	Baltic
бас	bass
безгранично	infinitely
бездомный	homeless
безмерно	immensely
бессонница	insomnia
библейский	biblical
благословение	blessing
вежливость (f)	politeness	f
богатырский	heroic
божественный	divine
братишка	little brother (coll)	g pl братишек
бревенчатый	made of logs
вена	vein
бюрократ	bureaucrat
варенье	jam, preserves
вглубь	into the depths
вдалеке	in the distance
вдоволь	in abundance; enough
вдохновлять/вдохновить (+a)	to inspire	i вдохновляю
ведьма	witch	g pl ведьм
великолепие	magnificence
веник	brush, bundle of twigs (for sweeping floor or beating body in sauna)
венок	wreath, garland
верхом	on horseback
вечность (f)	eternity	f
взывать/воззвать (к +d)	to appeal to
вишня	cherry	g pl вишен
включаться/включиться	to join; be included; be switched on
влетать/влететь	to fly in	p влечу, влетишь
влиятельный	influential
водиться (i)	(c +inst) to associate with; be, be found	i вожусь, водишься
возобновлять/возобновить (+a)	to renew	p возобновлю, возобновишь
воинственный	warlike
вопль (m)	wail, howl	m
воротничок	(small) collar
воспроизводить/воспроизвести (+a)	to reproduce	i воспроизвожу, воспроизводишь
восхищаться/восхититься (+inst)	to admire
вспылить (р)	to flare up (coll)
всхлипывать/всхлипнуть	to sob
всяческий	all kinds of (coll)
втягивать/втянуть (+a)	to pull in	p втяну, втянешь
выжимать/выжать (+a)	to squeeze out	p выжму, выжмешь
высаживать/высадить (+a)	to set down, land	p высажу, высадишь
высыпаться/выспаться	to get enough sleep	p высплюсь, выспишься
выяснение	explanation
вязать/с- (+a)	to tie; knit	i вяжу, вяжешь
гармония	harmony
героизм	heroism
гибкий	flexible
гимн	hymn, anthem
гипотеза	hypothesis
глотать (i) (+a)	to swallow
голенище	top (of a boot)
голодать (i)	to go hungry
голосование	voting
графин	carafe, decanter
громоздкий	cumbersome, bulky
гуманитарный	humanitarian; humanities (adj)	гуманитарные науки the Arts, humanities
гуща	dregs; thicket
даром	free, gratis
денёк	day (dim)	g sg денька
детальный	detailed
дефицит	deficit; shortage, shortages
джинсы (pl)	jeans	g pl джинсов
добросовестно	conscientiously
документация	documentation, documents
достаток	sufficiency; prosperity
драматический	dramatic
#METADATA:
#--columns russian,english,extra
#--listdelimiter |
